RepDate,SPName,Capacity,Enrollment,Waitlist,Vacancy
31/10/2017,(ADH) THK Home for the Disabled @ Eunos,88,80,31,8
31/10/2017,(ADH) Metta Home for the Disabled,103,92,10,11
31/10/2017,(ADH) THK Home for the Disabled @ Chai Chee,102,101,0,1
31/10/2017,(ADH) Bishan Home for the Intellectually Disabled,132,127,5,5
31/10/2017,(ADH) Blue Cross Thong Kheng Home,116,106,10,10
31/10/2017,(ADH) Red Cross Home for the Disabled,100,89,9,11
31/10/2017,(ADH) Singapore Cheshire Home,90,76,8,14
30/11/2017,(ADH) THK Home for the Disabled @ Eunos,88,80,29,8
30/11/2017,(ADH) Metta Home for the Disabled,103,91,11,12
30/11/2017,(ADH) THK Home for the Disabled @ Chai Chee,102,101,0,1
30/11/2017,(ADH) Bishan Home for the Intellectually Disabled,132,125,5,7
30/11/2017,(ADH) Blue Cross Thong Kheng Home,116,106,11,10
30/11/2017,(ADH) Red Cross Home for the Disabled,100,89,10,11
30/11/2017,(ADH) Singapore Cheshire Home,90,74,7,16
31/12/2017,(ADH) THK Home for the Disabled @ Eunos,88,82,25,6
31/12/2017,(ADH) Metta Home for the Disabled,103,92,9,11
31/12/2017,(ADH) Bishan Home for the Intellectually Disabled,132,126,3,6
31/12/2017,(ADH) THK Home for the Disabled @ Chai Chee,102,100,0,2
31/12/2017,(ADH) Blue Cross Thong Kheng Home,116,106,13,10
31/12/2017,(ADH) MINDSVille @ Napiri,160,122,14,38
31/12/2017,(ADH) Red Cross Home for the Disabled,100,91,11,9
31/12/2017,(ADH) Singapore Cheshire Home,90,74,7,16
31/7/2017,(ADH) Bishan Home for the Intellectually Disabled,132,127,5,5
31/7/2017,(ADH) THK Home for the Disabled @ Chai Chee,102,101,0,1
31/7/2017,(ADH) THK Home for the Disabled @ Eunos,88,78,32,10
31/7/2017,(ADH) Blue Cross Thong Kheng Home,116,106,5,10
31/7/2017,(ADH) MINDSVille @ Napiri,160,119,29,41
31/7/2017,(ADH) Red Cross Home for the Disabled,100,90,7,10
31/7/2017,(ADH) Singapore Cheshire Home,90,75,8,15
31/8/2017,(ADH) THK Home for the Disabled @ Eunos,88,79,34,9
31/8/2017,(ADH) Metta Home for the Disabled,103,92,6,11
31/8/2017,(ADH) Bishan Home for the Intellectually Disabled,132,127,5,5
31/8/2017,(ADH) THK Home for the Disabled @ Chai Chee,102,101,0,1
31/8/2017,(ADH) Blue Cross Thong Kheng Home,116,106,8,10
31/8/2017,(ADH) Red Cross Home for the Disabled,100,90,8,10
31/8/2017,(ADH) Singapore Cheshire Home,90,77,5,13
30/9/2017,(ADH) THK Home for the Disabled @ Eunos,88,79,32,9
30/9/2017,(ADH) Metta Home for the Disabled,103,90,6,13
30/9/2017,(ADH) Bishan Home for the Intellectually Disabled,132,127,5,5
30/9/2017,(ADH) THK Home for the Disabled @ Chai Chee,102,101,0,1
30/9/2017,(ADH) Blue Cross Thong Kheng Home,116,106,9,10
30/9/2017,(ADH) Red Cross Home for the Disabled,100,89,9,11
30/9/2017,(ADH) Singapore Cheshire Home,90,76,6,14
31/1/2018,(ADH) Bishan Home for the Intellectually Disabled,132,127,1,5
31/1/2018,(ADH) Metta Home for the Disabled,103,91,10,12
31/1/2018,(ADH) MINDSVille @ Napiri,160,123,13,37
31/1/2018,(ADH) Red Cross Home for the Disabled,100,91,11,9
31/1/2018,(ADH) THK Home for the Disabled @ Chai Chee,102,100,0,2
31/1/2018,(ADH) THK Home for the Disabled @ Eunos,88,82,21,6
31/10/2018,(ADH) THK Home for the Disabled @ Eunos,88,83,14,5
31/10/2018,(ADH) THK Home for Disabled @ Sembawang,180,58,50,122
31/10/2018,(ADH) Metta Home for the Disabled,103,89,7,14
31/10/2018,(ADH) MINDSVille @ Napiri,160,123,24,37
31/10/2018,(ADH) Red Cross Home for the Disabled,100,90,7,10
31/10/2018,(ADH) Singapore Cheshire Home,90,74,5,16
30/11/2018,(ADH) THK Home for Disabled @ Sembawang,180,57,50,123
30/11/2018,(ADH) Metta Home for the Disabled,103,89,8,14
30/11/2018,(ADH) MINDSVille @ Napiri,160,125,27,35
30/11/2018,(ADH) Singapore Cheshire Home,90,77,1,13
30/11/2018,(ADH) THK Home for the Disabled @ Chai Chee,102,98,3,4
30/11/2018,(ADH) THK Home for the Disabled @ Eunos,88,83,14,5
31/12/2018,(ADH) THK Home for the Disabled @ Chai Chee,102,97,4,5
31/12/2018,(ADH) Red Cross Home for the Disabled,100,89,9,11
31/12/2018,(ADH) Singapore Cheshire Home,90,74,2,16
28/2/2018,(ADH) Metta Home for the Disabled,103,91,10,12
28/2/2018,(ADH) THK Home for the Disabled @ Chai Chee,102,99,0,3
28/2/2018,(ADH) THK Home for the Disabled @ Eunos,88,82,21,6
28/2/2018,(ADH) MINDSVille @ Napiri,160,122,13,38
31/3/2018,(ADH) Bishan Home for the Intellectually Disabled,132,126,2,6
31/3/2018,(ADH) THK Home for the Disabled @ Eunos,88,81,23,7
31/3/2018,(ADH) Red Cross Home for the Disabled,100,92,15,8
31/3/2018,(ADH) Singapore Cheshire Home,90,75,6,15
30/4/2018,(ADH) THK Home for the Disabled @ Eunos,88,81,21,7
30/4/2018,(ADH) THK Home for Disabled @ Sembawang,180,13,92,167
30/4/2018,(ADH) THK Home for the Disabled @ Chai Chee,102,99,0,3
31/5/2018,(ADH) Blue Cross Thong Kheng Home,116,105,12,11
31/5/2018,(ADH) THK Home for the Disabled @ Chai Chee,102,99,0,3
31/5/2018,(ADH) THK Home for the Disabled @ Eunos,88,82,22,6
30/6/2018,(ADH) Blue Cross Thong Kheng Home,116,105,12,11
30/6/2018,(ADH) Bishan Home for the Intellectually Disabled,132,124,0,8
30/6/2018,(ADH) Red Cross Home for the Disabled,100,92,12,8
31/7/2018,(ADH) THK Home for the Disabled @ Eunos,88,83,24,5
31/7/2018,(ADH) Bishan Home for the Intellectually Disabled,132,120,1,12
31/7/2018,(ADH) Blue Cross Thong Kheng Home,116,106,12,10
31/7/2018,(ADH) Red Cross Home for the Disabled,100,89,7,11
31/7/2018,(ADH) Singapore Cheshire Home,90,77,4,13
31/7/2018,(ADH) THK Home for the Disabled @ Chai Chee,102,97,0,5
30/8/2018,(ADH) THK Home for Disabled @ Sembawang,180,42,59,138
31/8/2018,(ADH) Bishan Home for the Intellectually Disabled,132,122,1,10
30/8/2018,(ADH) Metta Home for the Disabled,103,89,7,14
31/8/2018,(ADH) Singapore Cheshire Home,90,79,5,11
30/9/2018,(ADH) MINDSVille @ Napiri,160,128,33,32
30/9/2018,(ADH) Bishan Home for the Intellectually Disabled,132,122,3,10
30/9/2018,(ADH) Metta Home for the Disabled,103,89,6,14
30/9/2018,(ADH) Singapore Cheshire Home,90,77,3,13
30/9/2018,(ADH) THK Home for Disabled @ Sembawang,180,52,56,128
31/3/2018,(ADH) Metta Home for the Disabled,103,91,8,12
31/3/2018,(ADH) Blue Cross Thong Kheng Home,116,105,8,11
31/3/2018,(ADH) MINDSVille @ Napiri,160,128,17,32
31/3/2018,(ADH) THK Home for the Disabled @ Chai Chee,102,99,0,3
30/4/2018,(ADH) Bishan Home for the Intellectually Disabled,132,126,1,6
30/4/2018,(ADH) MINDSVille @ Napiri,160,131,24,29
30/4/2018,(ADH) Singapore Cheshire Home,90,76,4,14
31/5/2018,(ADH) Singapore Cheshire Home,90,76,3,14
31/5/2018,(ADH) Metta Home for the Disabled,103,91,6,12
31/5/2018,(ADH) MINDSVille @ Napiri,160,124,14,36
31/1/2019,(ADH) THK Home for Disabled @ Sembawang,184,57,44,127
31/1/2019,(ADH) MINDSVille @ Napiri,160,124,27,36
31/1/2019,(ADH) Red Cross Home for the Disabled,100,90,10,10
31/1/2019,(ADH) THK Home for the Disabled @ Eunos,88,84,11,4
31/10/2019,(ADH) THK Home for the Disabled @ Chai Chee,102,99,9,3
31/10/2019,(ADH) Blue Cross Thong Kheng Home,116,96,7,20
31/10/2019,(ADH) Metta Home for the Disabled,103,87,2,16
31/10/2019,(ADH) Singapore Cheshire Home,90,72,5,18
30/11/2019,(ADH) THK Home for the Disabled @ Chai Chee,102,99,10,3
30/11/2019,(ADH) THK Home for Disabled @ Sembawang,180,86,29,94
30/11/2019,(ADH) Bishan Home for the Intellectually Disabled,132,126,1,6
30/11/2019,(ADH) MINDSVille @ Napiri,160,119,31,41
30/11/2019,(ADH) Red Cross Home for the Disabled,100,93,14,7
30/11/2019,(ADH) St Andrew's Adult Home (Sengkang),148,11,19,137
30/11/2019,(ADH) THK Home for the Disabled @ Eunos,88,81,10,7
31/12/2019,(ADH) Singapore Cheshire Home,90,73,5,17
28/2/2019,(ADH) Metta Home for the Disabled,103,88,6,15
28/2/2019,(ADH) MINDSVille @ Napiri,160,120,24,40
31/3/2019,(ADH) THK Home for the Disabled @ Chai Chee,102,99,13,3
31/3/2019,(ADH) Bishan Home for the Intellectually Disabled,132,121,6,11
31/3/2019,(ADH) Singapore Cheshire Home,90,71,3,19
31/3/2019,(ADH) THK Home for the Disabled @ Eunos,88,83,11,5
30/4/2019,(ADH) Bishan Home for the Intellectually Disabled,132,125,2,7
30/4/2019,(ADH) Metta Home for the Disabled,103,90,3,13
30/4/2019,(ADH) MINDSVille @ Napiri,160,125,23,35
30/4/2019,(ADH) Red Cross Home for the Disabled,100,91,5,9
30/4/2019,(ADH) Singapore Cheshire Home,90,70,3,20
31/5/2019,(ADH) St Andrew's Adult Home (Sengkang),148,3,15,145
31/5/2019,(ADH) THK Home for the Disabled @ Chai Chee,102,100,14,2
31/5/2019,(ADH) Metta Home for the Disabled,103,90,3,13
31/5/2019,(ADH) MINDSVille @ Napiri,160,124,28,36
31/5/2019,(ADH) Singapore Cheshire Home,90,69,6,21
31/5/2019,(ADH) THK Home for the Disabled @ Eunos,88,82,10,6
30/6/2019,(ADH) THK Home for the Disabled @ Chai Chee,102,100,15,2
30/6/2019,(ADH) THK Home for the Disabled @ Eunos,88,82,11,6
30/6/2019,(ADH) Bishan Home for the Intellectually Disabled,132,126,1,6
30/6/2019,(ADH) Metta Home for the Disabled,103,90,3,13
30/6/2019,(ADH) Singapore Cheshire Home,90,69,7,21
30/6/2019,(ADH) St Andrew's Adult Home (Sengkang),148,4,17,144
31/7/2019,(ADH) THK Home for the Disabled @ Chai Chee,102,100,13,2
31/7/2019,(ADH) Bishan Home for the Intellectually Disabled,132,126,0,6
31/7/2019,(ADH) Metta Home for the Disabled,103,90,3,13
31/7/2019,(ADH) Red Cross Home for the Disabled,100,92,8,8
31/7/2019,(ADH) St Andrew's Adult Home (Sengkang),148,6,18,142
31/8/2019,(ADH) Bishan Home for the Intellectually Disabled,132,126,0,6
31/8/2019,(ADH) Blue Cross Thong Kheng Home,116,98,4,18
31/8/2019,(ADH) Metta Home for the Disabled,103,89,4,14
31/8/2019,(ADH) MINDSVille @ Napiri,160,123,26,37
31/8/2019,(ADH) St Andrew's Adult Home (Sengkang),148,7,16,141
31/8/2019,(ADH) THK Home for the Disabled @ Eunos,88,83,10,5
30/9/2019,(ADH) THK Home for the Disabled @ Chai Chee,102,99,11,3
30/9/2019,(ADH) Bishan Home for the Intellectually Disabled,132,126,0,6
30/9/2019,(ADH) Blue Cross Thong Kheng Home,116,97,4,19
30/9/2019,(ADH) Metta Home for the Disabled,103,88,3,15
30/9/2019,(ADH) MINDSVille @ Napiri,160,122,32,38
30/9/2019,(ADH) Red Cross Home for the Disabled,100,93,13,7
30/9/2019,(ADH) Singapore Cheshire Home,90,70,5,20
30/9/2019,(ADH) THK Home for Disabled @ Sembawang,180,81,32,99
31/1/2020,(ADH) THK Home for the Disabled @ Chai Chee,102,99,9,3
31/1/2020,(ADH) Bishan Home for the Intellectually Disabled,132,125,0,7
31/1/2020,(ADH) Singapore Cheshire Home,90,74,3,16
31/1/2020,(ADH) THK Home for Disabled @ Sembawang,180,85,40,95
31/10/2020,(ADH) THK Home for the Disabled @ Chai Chee,102,97,8,5
31/10/2020,(ADH) Blue Cross Thong Kheng Home,116,93,5,23
31/10/2020,(ADH) MINDSVille @ Napiri,160,117,29,43
31/10/2020,(ADH) Red Cross Home for the Disabled,100,94,4,6
31/10/2020,(ADH) St Andrew's Adult Home (Sengkang),148,22,18,126
31/10/2020,(ADH) THK Home for Disabled @ Sembawang,180,118,37,62
30/11/2020,(ADH) Bishan Home for the Intellectually Disabled,132,125,0,7
30/11/2020,(ADH) Red Cross Home for the Disabled,100,94,3,6
30/11/2020,(ADH) St Andrew's Adult Home (Sengkang),148,22,18,126
30/11/2020,(ADH) THK Home for Disabled @ Sembawang,180,119,36,61
31/12/2020,(ADH) Bishan Home for the Intellectually Disabled,132,125,0,7
31/12/2020,(ADH) MINDSVille @ Napiri,160,120,29,40
31/12/2020,(ADH) Red Cross Home for the Disabled,100,95,2,5
31/12/2020,(ADH) St Andrew's Adult Home (Sengkang),148,21,17,127
31/12/2020,(ADH) THK Home for the Disabled @ Chai Chee,102,96,11,6
31/12/2020,(ADH) THK Home for Disabled @ Sembawang,180,120,37,60
29/2/2020,(ADH) THK Home for the Disabled @ Chai Chee,102,99,10,3
29/2/2020,(ADH) Blue Cross Thong Kheng Home,116,96,9,20
29/2/2020,(ADH) Red Cross Home for the Disabled,100,95,8,5
29/2/2020,(ADH) Singapore Cheshire Home,90,75,1,15
31/3/2020,(ADH) THK Home for the Disabled @ Chai Chee,102,99,10,3
31/3/2020,(ADH) THK Home for Disabled @ Sembawang,180,82,30,98
31/3/2020,(ADH) Blue Cross Thong Kheng Home,116,97,6,19
31/3/2020,(ADH) Metta Home for the Disabled,103,86,3,17
31/3/2020,(ADH) Singapore Cheshire Home,90,75,1,15
31/3/2020,(ADH) St Andrew's Adult Home (Sengkang),148,13,22,135
31/3/2020,(ADH) THK Home for the Disabled @ Eunos,88,81,12,7
30/4/2020,(ADH) MINDSVille @ Napiri,160,117,26,43
30/4/2020,(ADH) Red Cross Home for the Disabled,100,95,6,5
30/4/2020,(ADH) Singapore Cheshire Home,90,74,0,16
30/4/2020,(ADH) St Andrew's Adult Home (Sengkang),148,13,33,135
30/4/2020,(ADH) THK Home for the Disabled @ Eunos,88,84,12,4
31/5/2020,(ADH) THK Home for the Disabled @ Chai Chee,102,103,13,-1
31/5/2020,(ADH) Bishan Home for the Intellectually Disabled,132,124,2,8
31/5/2020,(ADH) THK Home for the Disabled @ Eunos,88,87,12,1
30/6/2020,(ADH) Blue Cross Thong Kheng Home,116,95,5,21
30/6/2020,(ADH) MINDSVille @ Napiri,160,117,25,43
30/6/2020,(ADH) Red Cross Home for the Disabled,100,95,6,5
30/6/2020,(ADH) THK Home for the Disabled @ Eunos,88,87,12,1
31/7/2020,(ADH) THK Home for the Disabled @ Chai Chee,102,94,13,8
31/7/2020,(ADH) THK Home for the Disabled @ Eunos,88,85,12,3
31/7/2020,(ADH) THK Home for Disabled @ Sembawang,180,115,27,65
31/8/2020,(ADH) THK Home for the Disabled @ Chai Chee,102,95,11,7
31/8/2020,(ADH) THK Home for the Disabled @ Eunos,88,84,12,4
31/8/2020,(ADH) MINDSVille @ Napiri,160,117,24,43
31/8/2020,(ADH) Red Cross Home for the Disabled,100,94,5,6
31/8/2020,(ADH) THK Home for Disabled @ Sembawang,180,118,28,62
30/9/2020,(ADH) Bishan Home for the Intellectually Disabled,132,124,1,8
30/9/2020,(ADH) Blue Cross Thong Kheng Home,116,93,4,23
30/9/2020,(ADH) MINDSVille @ Napiri,160,117,26,43
30/9/2020,(ADH) St Andrew's Adult Home (Sengkang),148,22,31,126
30/9/2020,(ADH) THK Home for Disabled @ Sembawang,180,117,34,63
31/1/2021,(ADH) MINDSVille @ Napiri,160,118,29,42
31/1/2021,(ADH) Red Cross Home for the Disabled,100,95,3,5
31/1/2021,(ADH) THK Home for the Disabled @ Chai Chee,102,95,13,7
31/10/2021,(ADH) Bishan Home for the Intellectually Disabled,132,124,3,8
31/10/2021,(ADH) MINDSVille @ Napiri,160,117,36,43
31/10/2021,(ADH) Red Cross Home for the Disabled,100,94,9,6
31/10/2021,(ADH) Singapore Cheshire Home,90,74,5,16
30/11/2021,(ADH) Blue Cross Thong Kheng Home,116,88,14,28
30/11/2021,(ADH) Metta Home for the Disabled,103,86,1,17
30/11/2021,(ADH) MINDSVille @ Napiri,160,119,36,41
30/11/2021,(ADH) Singapore Cheshire Home,90,74,6,16
30/11/2021,(ADH) THK Home for the Disabled @ Chai Chee,102,96,14,6
30/11/2021,(ADH) THK Home for the Disabled @ Eunos,88,76,17,12
31/12/2021,(ADH) Blue Cross Thong Kheng Home,116,88,15,28
31/12/2021,(ADH) MINDSVille @ Napiri,160,116,34,44
31/12/2021,(ADH) St Andrew's Adult Home (Sengkang),148,20,18,128
28/2/2021,(ADH) MINDSVille @ Napiri,160,115,27,45
28/2/2021,(ADH) Red Cross Home for the Disabled,100,95,5,5
28/2/2021,(ADH) Singapore Cheshire Home,90,73,7,17
28/2/2021,(ADH) St Andrew's Adult Home (Sengkang),148,21,16,127
28/2/2021,(ADH) THK Home for Disabled @ Sembawang,180,123,35,57
31/3/2021,(ADH) Blue Cross Thong Kheng Home,116,91,5,25
31/3/2021,(ADH) Metta Home for the Disabled,103,86,2,17
31/3/2021,(ADH) St Andrew's Adult Home (Sengkang),148,21,15,127
30/4/2021,(ADH) Blue Cross Thong Kheng Home,116,91,7,25
30/4/2021,(ADH) Red Cross Home for the Disabled,100,95,6,5
30/4/2021,(ADH) Singapore Cheshire Home,90,73,6,17
30/4/2021,(ADH) St Andrew's Adult Home (Sengkang),148,21,15,127
30/4/2021,(ADH) THK Home for the Disabled @ Chai Chee,102,95,13,7
30/4/2021,(ADH) THK Home for the Disabled @ Eunos,88,81,14,7
30/4/2021,(ADH) THK Home for Disabled @ Sembawang,180,123,29,57
31/5/2021,(ADH) Blue Cross Thong Kheng Home,116,90,9,26
31/5/2021,(ADH) Singapore Cheshire Home,90,72,5,18
30/6/2021,(ADH) Metta Home for the Disabled,103,86,5,17
30/6/2021,(ADH) Bishan Home for the Intellectually Disabled,132,123,2,9
30/6/2021,(ADH) Blue Cross Thong Kheng Home,116,90,9,26
30/6/2021,(ADH) MINDSVille @ Napiri,160,116,31,44
30/6/2021,(ADH) Red Cross Home for the Disabled,100,96,7,4
30/6/2021,(ADH) Singapore Cheshire Home,90,72,8,18
30/6/2021,(ADH) THK Home for Disabled @ Sembawang,180,124,30,56
31/7/2021,(ADH) Bishan Home for the Intellectually Disabled,132,123,2,9
31/7/2021,(ADH) Singapore Cheshire Home,90,72,8,18
30/7/2021,(ADH) THK Home for the Disabled @ Chai Chee,102,97,11,5
31/8/2021,(ADH) Red Cross Home for the Disabled,100,96,10,4
30/9/2021,(ADH) Bishan Home for the Intellectually Disabled,132,124,3,8
30/9/2021,(ADH) Blue Cross Thong Kheng Home,116,88,13,28
30/9/2021,(ADH) MINDSVille @ Napiri,160,116,36,44
30/9/2021,(ADH) Red Cross Home for the Disabled,100,96,9,4
30/9/2021,(ADH) Singapore Cheshire Home,90,73,5,17
31/1/2022,(ADH) MINDSVille @ Napiri,160,116,34,44
31/1/2022,(ADH) Red Cross Home for the Disabled,100,86,13,14
31/1/2022,(ADH) Singapore Cheshire Home,90,74,5,16
31/1/2022,(ADH) THK Home for the Disabled @ Chai Chee,102,96,17,6
31/10/2017,(Hostel) THK Home for the Disabled @ Eunos,40,42,20,-2
31/10/2017,(Hostel) MINDSVille @ Napiri,60,50,5,10
31/10/2017,(Hostel) Touch Ubi Hostel,30,29,3,1
30/11/2017,(Hostel) THK Home for the Disabled @ Eunos,40,42,21,-2
30/11/2017,(Hostel) MINDSVille @ Napiri,60,51,4,9
30/11/2017,(Hostel) Touch Ubi Hostel,30,29,3,1
31/12/2017,(Hostel) THK Home for the Disabled @ Eunos,40,43,20,-3
31/12/2017,(Hostel) MINDSVille @ Napiri,60,52,7,8
31/12/2017,(Hostel) Touch Ubi Hostel,30,30,3,0
31/7/2017,(Hostel) MINDSVille @ Napiri,60,51,4,9
31/7/2017,(Hostel) THK Home for the Disabled @ Eunos,40,39,15,1
31/7/2017,(Hostel) Touch Ubi Hostel,30,28,1,2
31/8/2017,(Hostel) THK Home for the Disabled @ Eunos,40,42,17,-2
31/8/2017,(Hostel) MINDSVille @ Napiri,60,54,3,6
31/8/2017,(Hostel) Touch Ubi Hostel,30,28,3,2
30/9/2017,(Hostel) THK Home for the Disabled @ Eunos,40,41,17,-1
30/9/2017,(Hostel) MINDSVille @ Napiri,60,52,4,8
30/9/2017,(Hostel) Touch Ubi Hostel,30,28,3,2
31/1/2018,(Hostel) Touch Ubi Hostel,30,29,3,1
31/1/2018,(Hostel) MINDSVille @ Napiri,60,48,6,12
31/1/2018,(Hostel) THK Home for the Disabled @ Eunos,40,40,17,0
31/10/2018,(Hostel) THK Home for the Disabled @ Eunos,40,38,21,2
30/11/2018,(Hostel) THK Home for the Disabled @ Eunos,40,38,19,2
31/12/2018,(Hostel) MINDSVille @ Napiri,60,50,12,10
31/12/2018,(Hostel) THK Home for the Disabled @ Eunos,40,37,19,3
28/2/2018,(Hostel) Touch Ubi Hostel,30,30,3,0
28/2/2018,(Hostel) MINDSVille @ Napiri,60,49,8,11
28/2/2018,(Hostel) THK Home for the Disabled @ Eunos,40,39,17,1
31/3/2018,(Hostel) MINDSVille @ Napiri,60,49,7,11
31/3/2018,(Hostel) Touch Ubi Hostel,30,30,3,0
30/4/2018,(Hostel) THK Home for the Disabled @ Eunos,40,38,18,2
31/5/2018,(Hostel) Touch Ubi Hostel,30,30,4,0
31/5/2018,(Hostel) MINDSVille @ Napiri,60,49,7,11
31/5/2018,(Hostel) THK Home for the Disabled @ Eunos,40,37,28,3
30/6/2018,(Hostel) MINDSVille @ Napiri,60,49,7,11
31/7/2018,(Hostel) MINDSVille @ Napiri,60,50,11,10
30/8/2018,(Hostel) THK Home for the Disabled @ Eunos,40,38,23,2
30/8/2018,(Hostel) Touch Ubi Hostel,30,30,4,0
31/10/2019,(Hostel) MINDSVille @ Napiri,60,50,15,10
30/11/2019,(Hostel) THK Home for the Disabled @ Eunos,40,42,22,-2
30/11/2019,(Hostel) Touch Ubi Hostel,30,29,7,1
31/12/2019,(Hostel) Touch Ubi Hostel,30,29,7,1
28/2/2019,(Hostel) MINDSVille @ Napiri,60,51,15,9
28/2/2019,(Hostel) THK Home for the Disabled @ Eunos,40,39,22,1
31/3/2019,(Hostel) Touch Ubi Hostel,30,30,5,0
31/3/2019,(Hostel) MINDSVille @ Napiri,60,51,16,9
31/3/2019,(Hostel) THK Home for the Disabled @ Eunos,40,40,21,0
30/4/2019,(Hostel) MINDSVille @ Napiri,60,50,17,10
30/4/2019,(Hostel) THK Home for the Disabled @ Eunos,40,42,21,-2
31/5/2019,(Hostel) Touch Ubi Hostel,30,31,4,-1
30/6/2019,(Hostel) THK Home for the Disabled @ Eunos,40,42,22,-2
30/6/2019,(Hostel) Touch Ubi Hostel,30,31,5,-1
31/7/2019,(Hostel) Touch Ubi Hostel,30,31,5,-1
31/7/2019,(Hostel) MINDSVille @ Napiri,60,50,15,10
31/7/2019,(Hostel) THK Home for the Disabled @ Eunos,40,43,20,-3
31/8/2019,(Hostel) Touch Ubi Hostel,30,31,5,-1
31/8/2019,(Hostel) MINDSVille @ Napiri,60,50,14,10
31/8/2019,(Hostel) THK Home for the Disabled @ Eunos,40,43,22,-3
30/9/2019,(Hostel) MINDSVille @ Napiri,60,49,14,11
31/1/2020,(Hostel) Touch Ubi Hostel,30,29,7,1
31/10/2020,(Hostel) THK Home for the Disabled @ Eunos,40,41,26,-1
30/11/2020,(Hostel) THK Home for the Disabled @ Eunos,40,40,27,0
29/2/2020,(Hostel) Touch Ubi Hostel,30,30,6,0
29/2/2020,(Hostel) THK Home for the Disabled @ Eunos,40,42,24,-2
31/3/2020,(Hostel) Touch Ubi Hostel,30,30,6,0
30/4/2020,(Hostel) MINDSVille @ Napiri,60,45,34,15
31/5/2020,(Hostel) THK Home for the Disabled @ Eunos,40,39,23,1
30/6/2020,(Hostel) MINDSVille @ Napiri,60,46,34,14
30/6/2020,(Hostel) THK Home for the Disabled @ Eunos,40,37,23,3
31/7/2020,(Hostel) MINDSVille @ Napiri,60,47,35,13
31/8/2020,(Hostel) THK Home for the Disabled @ Eunos,40,37,23,3
31/8/2020,(Hostel) Touch Ubi Hostel,30,29,6,1
30/9/2020,(Hostel) MINDSVille @ Napiri,60,47,36,13
30/9/2020,(Hostel) THK Home for the Disabled @ Eunos,40,42,23,-2
30/9/2020,(Hostel) Touch Ubi Hostel,30,29,6,1
31/1/2021,(Hostel) Touch Ubi Hostel,30,29,3,1
31/10/2021,(Hostel) MINDSVille @ Napiri,60,48,49,12
31/10/2021,(Hostel) THK Home for the Disabled @ Eunos,40,40,37,0
30/11/2021,(Hostel) Touch Ubi Hostel,30,29,5,1
31/12/2021,(Hostel) MINDSVille @ Napiri,60,48,50,12
28/2/2021,(Hostel) THK Home for the Disabled @ Eunos,40,40,31,0
31/3/2021,(Hostel) Touch Ubi Hostel,30,29,2,1
30/4/2021,(Hostel) MINDSVille @ Napiri,60,50,42,10
30/4/2021,(Hostel) THK Home for the Disabled @ Eunos,40,39,34,1
30/6/2021,(Hostel) THK Home for the Disabled @ Eunos,40,40,35,0
31/7/2021,(Hostel) MINDSVille @ Napiri,60,49,43,11
31/7/2021,(Hostel) THK Home for the Disabled @ Eunos,40,40,34,0
31/7/2021,(Hostel) Touch Ubi Hostel,30,29,5,1
31/8/2021,(Hostel) THK Home for the Disabled @ Eunos,40,40,36,0
30/9/2021,(Hostel) MINDSVille @ Napiri,60,47,47,13
30/9/2021,(Hostel) THK Home for the Disabled @ Eunos,40,40,37,0
31/1/2022,(Hostel) Touch Ubi Hostel,30,29,5,1
31/10/2017,(CGH) MINDSVille @ Napiri,10,8,1,2
30/11/2017,(CGH) MINDSVille @ Napiri,10,8,1,2
31/12/2017,(CGH) MINDSVille @ Napiri,10,8,1,2
31/7/2017,(CGH) MINDSVille @ Napiri,10,7,3,3
31/8/2017,(CGH) MINDSVille @ Napiri,10,7,2,3
30/9/2017,(CGH) MINDSVille @ Napiri,10,7,2,3
31/1/2018,(CGH) MINDSVille @ Napiri,10,8,1,2
31/12/2018,(CGH) MINDSVille @ Napiri,10,8,3,2
28/2/2018,(CGH) MINDSVille @ Napiri,10,8,2,2
31/3/2018,(CGH) MINDSVille @ Napiri,10,8,2,2
31/8/2018,(CGH) MINDSVille @ Napiri,10,8,4,2
31/10/2019,(CGH) MINDSVille @ Napiri,10,8,7,2
31/3/2019,(CGH) MINDSVille @ Napiri,10,8,5,2
30/4/2019,(CGH) MINDSVille @ Napiri,10,8,5,2
31/5/2019,(CGH) MINDSVille @ Napiri,10,8,5,2
31/10/2020,(CGH) MINDSVille @ Napiri,10,8,8,2
31/12/2020,(CGH) MINDSVille @ Napiri,10,8,8,2
30/4/2020,(CGH) MINDSVille @ Napiri,10,8,7,2
31/7/2020,(CGH) MINDSVille @ Napiri,10,8,8,2
31/8/2020,(CGH) MINDSVille @ Napiri,10,8,8,2
30/9/2020,(CGH) MINDSVille @ Napiri,10,8,8,2
28/2/2021,(CGH) MINDSVille @ Napiri,10,8,8,2
31/3/2021,(CGH) MINDSVille @ Napiri,10,8,8,2
30/4/2021,(CGH) MINDSVille @ Napiri,10,8,8,2
30/11/2017,(DAC) Bishan Home for the Intellectually Disabled,50,26,0,24
30/11/2017,(DAC) Blue Cross Thong Kheng ASD Day Activity Centre,62,1,16,61
30/11/2017,(DAC) Red Cross Day Activity Centre,50,12,4,38
30/11/2017,(DAC) Blue Cross Thong Kheng Home,50,33,4,17
30/11/2017,(DAC) Metta Home @ Woodlands,50,32,0,18
31/12/2017,(DAC) Bishan Home for the Intellectually Disabled,50,25,0,25
31/12/2017,(DAC) Blue Cross Thong Kheng ASD Day Activity Centre,62,4,14,58
31/12/2017,(DAC) Blue Cross Thong Kheng Home,50,33,3,17
31/12/2017,(DAC) MINDS Training & Development Centre @ Jurong,53,38,9,15
31/12/2017,(DAC) Red Cross Day Activity Centre,50,12,4,38
31/12/2017,(DAC) Metta Home @ Woodlands,50,32,0,18
31/7/2017,(DAC) THK Autism Centre @ Geylang Bahru,74,20,12,54
31/7/2017,(DAC) THK Day Activity Centre @ Chai Chee,50,23,1,27
31/7/2017,(DAC) Bishan Home for the Intellectually Disabled,50,25,3,25
31/7/2017,(DAC) Metta Home @ Woodlands,50,32,0,18
31/7/2017,(DAC) Singapore Cheshire Home,50,31,1,19
31/7/2017,(DAC) Blue Cross Thong Kheng Home,50,33,3,17
31/7/2017,(DAC) Red Cross Day Activity Centre,50,13,2,37
31/8/2017,(DAC) Bishan Home for the Intellectually Disabled,50,25,1,25
31/8/2017,(DAC) Red Cross Day Activity Centre,50,13,3,37
31/8/2017,(DAC) Singapore Cheshire Home,50,31,1,19
31/8/2017,(DAC) Blue Cross Thong Kheng Home,50,33,4,17
31/8/2017,(DAC) Blue Cross Thong Kheng ASD Day Activity Centre,62,0,4,62
30/9/2017,(DAC) Blue Cross Thong Kheng ASD Day Activity Centre,62,0,11,62
30/9/2017,(DAC) Singapore Cheshire Home,50,32,0,18
30/9/2017,(DAC) Bishan Home for the Intellectually Disabled,50,25,1,25
30/9/2017,(DAC) Red Cross Day Activity Centre,50,13,3,37
30/9/2017,(DAC) Blue Cross Thong Kheng Home,50,33,4,17
30/9/2017,(DAC) Metta Home @ Woodlands,50,32,0,18
31/1/2018,(DAC) Bishan Home for the Intellectually Disabled,50,25,0,25
31/1/2018,(DAC) Metta Home @ Woodlands,50,30,0,20
31/1/2018,(DAC) MINDS Training & Development Centre @ Jurong,53,41,4,12
31/1/2018,(DAC) Red Cross Day Activity Centre,50,12,4,38
31/1/2018,(DAC) THK Autism Centre @ Geylang Bahru,74,21,19,53
28/2/2018,(DAC) TOUCH Centre for Independent Living - Ubi,50,53,3,-3
31/1/2018,(DAC) THK Day Activity Centre @ Chai Chee,50,23,1,27
31/10/2018,(DAC) THK Autism Centre @ Geylang Bahru,66,21,15,45
31/10/2018,(DAC) MINDS Training & Development Centre @ Tampines,48,52,6,-4
31/10/2018,(DAC) BizLink Day Activity Centre,40,29,11,11
31/10/2018,(DAC) Blue Cross Thong Kheng ASD Day Activity Centre,60,14,8,46
31/10/2018,(DAC) Blue Cross Thong Kheng Home,50,31,2,19
31/10/2018,(DAC) Emmanuel Activity Centre @ Tampines,50,52,4,-2
31/10/2018,(DAC) Emmanuel Activity Centre @ Toa Payoh,83,50,11,33
31/10/2018,(DAC) Cerebral Palsy Alliance Singapore,50,50,16,0
31/10/2018,(DAC) Eden Centre for Adults @ Clementi,40,39,10,1
31/10/2018,(DAC) Eden Centre for Adults @ Hougang,40,37,4,3
31/10/2018,(DAC) Metta Home @ Hougang,40,35,3,5
31/10/2018,(DAC) Metta Home @ Woodlands,50,29,1,21
31/10/2018,(DAC) MINDS Training & Development Centre @ Ang Mo Kio,55,46,4,9
31/10/2018,(DAC) MINDS Training & Development Centre @ Clementi,55,46,5,9
31/10/2018,(DAC) MINDS Training & Development Centre @ Eunos,100,69,3,31
31/10/2018,(DAC) MINDS Training & Development Centre @ Faber,41,33,2,8
31/10/2018,(DAC) MINDS Training & Development Centre @ Jurong,53,41,3,12
31/10/2018,(DAC) MINDS Training & Development Centre @ Napiri,50,59,14,-9
31/10/2018,(DAC) MINDS Training & Development Centre @ Yishun,61,51,6,10
31/10/2018,(DAC) Red Cross Day Activity Centre,50,13,1,37
31/10/2018,(DAC) Singapore Cheshire Home,50,26,3,24
31/10/2018,(DAC) SPD Day Activity Centre,91,71,17,20
31/10/2018,(DAC) St Andrew's Autism Centre (Siglap),97,90,17,7
31/10/2018,(DAC) SUN-DAC @ Bedok,50,45,2,5
31/10/2018,(DAC) SUN-DAC @ Choa Chu Kang,50,48,4,2
31/10/2018,(DAC) SUN-DAC @ Upper Thomson,120,23,21,97
31/10/2018,(DAC) THK Day Activity Centre @ Chai Chee,50,20,3,30
31/10/2018,(DAC) TOUCH Centre for Independent Living - Bukit Merah,42,21,1,21
31/10/2018,(DAC) TOUCH Centre for Independent Living - Ubi,50,38,2,12
30/11/2018,(DAC) Metta Home @ Hougang,40,35,3,5
30/11/2018,(DAC) Bishan Home for the Intellectually Disabled,50,26,0,24
30/11/2018,(DAC) BizLink Day Activity Centre,40,27,13,13
30/11/2018,(DAC) Blue Cross Thong Kheng ASD Day Activity Centre,60,14,8,46
30/11/2018,(DAC) Blue Cross Thong Kheng Home,50,31,2,19
30/11/2018,(DAC) Emmanuel Activity Centre @ Tampines,50,53,3,-3
30/11/2018,(DAC) Emmanuel Activity Centre @ Toa Payoh,83,53,11,30
30/11/2018,(DAC) Cerebral Palsy Alliance Singapore,50,50,16,0
30/11/2018,(DAC) Eden Centre for Adults @ Clementi,40,46,9,-6
30/11/2018,(DAC) Eden Centre for Adults @ Hougang,40,38,4,2
30/11/2018,(DAC) Metta Home @ Woodlands,50,29,1,21
30/11/2018,(DAC) MINDS Training & Development Centre @ Ang Mo Kio,55,46,5,9
30/11/2018,(DAC) MINDS Training & Development Centre @ Clementi,55,45,4,10
30/11/2018,(DAC) MINDS Training & Development Centre @ Eunos,100,69,3,31
30/11/2018,(DAC) MINDS Training & Development Centre @ Faber,41,33,9,8
30/11/2018,(DAC) MINDS Training & Development Centre @ Jurong,53,41,4,12
30/11/2018,(DAC) MINDS Training & Development Centre @ Napiri,50,60,13,-10
30/11/2018,(DAC) MINDS Training & Development Centre @ Tampines,48,52,8,-4
30/11/2018,(DAC) MINDS Training & Development Centre @ Yishun,61,50,7,11
30/11/2018,(DAC) Red Cross Day Activity Centre,50,13,1,37
30/11/2018,(DAC) Singapore Cheshire Home,50,26,3,24
30/11/2018,(DAC) SPD Day Activity Centre,91,73,18,18
30/11/2018,(DAC) St Andrew's Autism Centre (Siglap),97,89,15,8
30/11/2018,(DAC) SUN-DAC @ Bedok,50,47,2,3
30/11/2018,(DAC) SUN-DAC @ Choa Chu Kang,50,51,2,-1
30/11/2018,(DAC) SUN-DAC @ Upper Thomson,120,22,21,98
30/11/2018,(DAC) THK Day Activity Centre @ Chai Chee,50,21,2,29
30/11/2018,(DAC) THK Autism Centre @ Geylang Bahru,66,22,11,44
30/11/2018,(DAC) TOUCH Centre for Independent Living - Bukit Merah,42,21,2,21
30/11/2018,(DAC) TOUCH Centre for Independent Living - Ubi,50,38,2,12
31/12/2018,(DAC) THK Day Activity Centre @ Chai Chee,50,21,2,29
31/12/2018,(DAC) THK Autism Centre @ Geylang Bahru,66,11,10,55
31/12/2018,(DAC) TOUCH Centre for Independent Living - Bukit Merah,42,21,2,21
31/12/2018,(DAC) TOUCH Centre for Independent Living - Ubi,50,38,2,12
31/12/2018,(DAC) Bishan Home for the Intellectually Disabled,50,25,0,25
31/12/2018,(DAC) BizLink Day Activity Centre,40,32,8,8
31/12/2018,(DAC) Blue Cross Thong Kheng ASD Day Activity Centre,60,14,9,46
31/12/2018,(DAC) Blue Cross Thong Kheng Home,50,31,1,19
31/12/2018,(DAC) Emmanuel Activity Centre @ Tampines,50,53,3,-3
31/12/2018,(DAC) Emmanuel Activity Centre @ Toa Payoh,83,53,12,30
31/12/2018,(DAC) Cerebral Palsy Alliance Singapore,50,50,17,0
31/12/2018,(DAC) Eden Centre for Adults @ Clementi,40,46,11,-6
31/12/2018,(DAC) Eden Centre for Adults @ Hougang,40,39,3,1
31/12/2018,(DAC) Metta Home @ Hougang,40,33,3,7
31/12/2018,(DAC) Metta Home @ Woodlands,50,29,1,21
31/12/2018,(DAC) MINDS Training & Development Centre @ Ang Mo Kio,55,45,4,10
31/12/2018,(DAC) MINDS Training & Development Centre @ Clementi,55,44,4,11
31/12/2018,(DAC) MINDS Training & Development Centre @ Eunos,100,69,4,31
31/12/2018,(DAC) MINDS Training & Development Centre @ Faber,41,34,9,7
31/12/2018,(DAC) MINDS Training & Development Centre @ Jurong,53,41,4,12
31/12/2018,(DAC) MINDS Training & Development Centre @ Napiri,50,61,10,-11
31/12/2018,(DAC) MINDS Training & Development Centre @ Tampines,48,53,10,-5
31/12/2018,(DAC) MINDS Training & Development Centre @ Yishun,61,49,7,12
31/12/2018,(DAC) Red Cross Day Activity Centre,50,13,2,37
31/12/2018,(DAC) Singapore Cheshire Home,50,26,2,24
31/12/2018,(DAC) SPD Day Activity Centre,91,74,17,17
31/12/2018,(DAC) St Andrew's Autism Centre (Siglap),97,89,14,8
31/12/2018,(DAC) SUN-DAC @ Bedok,50,47,2,3
31/12/2018,(DAC) SUN-DAC @ Choa Chu Kang,50,50,2,0
31/12/2018,(DAC) SUN-DAC @ Upper Thomson,120,23,17,97
28/2/2018,(DAC) Metta Home @ Woodlands,50,30,1,20
28/2/2018,(DAC) MINDS Training & Development Centre @ Jurong,53,43,2,10
28/2/2018,(DAC) THK Autism Centre @ Geylang Bahru,74,21,21,53
31/5/2018,(DAC) THK Day Activity Centre @ Chai Chee,50,23,2,27
31/3/2018,(DAC) Metta Home @ Hougang,40,35,4,5
31/3/2018,(DAC) Metta Home @ Woodlands,50,30,1,20
31/3/2018,(DAC) THK Autism Centre @ Geylang Bahru,74,22,21,52
31/3/2018,(DAC) Red Cross Day Activity Centre,50,13,4,37
31/3/2018,(DAC) MINDS Training & Development Centre @ Jurong,53,45,0,8
31/3/2018,(DAC) THK Day Activity Centre @ Chai Chee,50,23,1,27
31/3/2018,(DAC) TOUCH Centre for Independent Living - Ubi,50,51,7,-1
31/3/2018,(DAC) Bishan Home for the Intellectually Disabled,50,25,0,25
31/3/2018,(DAC) Blue Cross Thong Kheng ASD Day Activity Centre,62,12,8,50
31/3/2018,(DAC) Blue Cross Thong Kheng Home,50,33,1,17
30/4/2018,(DAC) Blue Cross Thong Kheng Home,50,33,2,17
30/4/2018,(DAC) Blue Cross Thong Kheng ASD Day Activity Centre,62,13,7,49
30/4/2018,(DAC) Red Cross Day Activity Centre,50,13,2,37
30/4/2018,(DAC) THK Autism Centre @ Geylang Bahru,74,22,21,52
30/4/2018,(DAC) TOUCH Centre for Independent Living - Bukit Merah,42,19,0,23
30/4/2018,(DAC) TOUCH Centre for Independent Living - Ubi,50,34,8,16
30/4/2018,(DAC) Metta Home @ Hougang,40,35,4,5
30/4/2018,(DAC) Metta Home @ Woodlands,50,29,1,21
30/4/2018,(DAC) MINDS Training & Development Centre @ Jurong,53,45,0,8
30/4/2018,(DAC) Bishan Home for the Intellectually Disabled,50,25,0,25
30/4/2018,(DAC) THK Day Activity Centre @ Chai Chee,50,23,1,27
31/5/2018,(DAC) THK Autism Centre @ Geylang Bahru,74,22,20,52
31/5/2018,(DAC) Blue Cross Thong Kheng Home,50,33,2,17
31/5/2018,(DAC) Blue Cross Thong Kheng ASD Day Activity Centre,62,13,5,49
31/5/2018,(DAC) Red Cross Day Activity Centre,50,13,3,37
31/5/2018,(DAC) Metta Home @ Hougang,40,35,4,5
31/5/2018,(DAC) Bishan Home for the Intellectually Disabled,50,25,1,25
31/5/2018,(DAC) Metta Home @ Woodlands,50,29,1,21
31/5/2018,(DAC) MINDS Training & Development Centre @ Jurong,53,45,2,8
31/5/2018,(DAC) TOUCH Centre for Independent Living - Bukit Merah,42,19,1,23
31/5/2018,(DAC) TOUCH Centre for Independent Living - Ubi,50,37,6,13
30/6/2018,(DAC) Blue Cross Thong Kheng Home,50,33,1,17
30/6/2018,(DAC) Metta Home @ Hougang,40,35,4,5
30/6/2018,(DAC) Singapore Cheshire Home,50,28,0,22
30/6/2018,(DAC) THK Autism Centre @ Geylang Bahru,74,22,19,52
30/6/2018,(DAC) Bishan Home for the Intellectually Disabled,50,25,1,25
30/6/2018,(DAC) Blue Cross Thong Kheng ASD Day Activity Centre,62,16,3,46
30/6/2018,(DAC) Red Cross Day Activity Centre,50,13,2,37
30/6/2018,(DAC) BizLink Day Activity Centre,40,38,13,2
30/6/2018,(DAC) Emmanuel Activity Centre @ Tampines,50,51,5,-1
30/6/2018,(DAC) Emmanuel Activity Centre @ Toa Payoh,83,50,5,33
30/6/2018,(DAC) Cerebral Palsy Alliance Singapore,50,50,6,0
30/6/2018,(DAC) Eden Centre for Adults @ Clementi,40,39,11,1
30/6/2018,(DAC) Eden Centre for Adults @ Hougang,40,37,3,3
30/6/2018,(DAC) Metta Home @ Woodlands,50,29,1,21
30/6/2018,(DAC) MINDS Training & Development Centre @ Ang Mo Kio,55,50,2,5
30/6/2018,(DAC) MINDS Training & Development Centre @ Clementi,55,45,0,10
30/6/2018,(DAC) MINDS Training & Development Centre @ Eunos,100,69,0,31
30/6/2018,(DAC) MINDS Training & Development Centre @ Faber,41,33,3,8
30/6/2018,(DAC) MINDS Training & Development Centre @ Jurong,53,45,3,8
30/6/2018,(DAC) MINDS Training & Development Centre @ Napiri,50,62,14,-12
30/6/2018,(DAC) MINDS Training & Development Centre @ Tampines,48,50,5,-2
30/6/2018,(DAC) MINDS Training & Development Centre @ Yishun,61,51,5,10
30/6/2018,(DAC) SPD Day Activity Centre,60,60,19,0
30/6/2018,(DAC) St Andrew's Autism Centre (Siglap),78,89,26,-11
30/6/2018,(DAC) SUN-DAC @ Bedok,50,46,2,4
30/6/2018,(DAC) SUN-DAC @ Choa Chu Kang,50,49,8,1
30/6/2018,(DAC) SUN-DAC @ Upper Thomson,120,9,13,111
30/6/2018,(DAC) THK Day Activity Centre @ Chai Chee,50,21,2,29
30/6/2018,(DAC) TOUCH Centre for Independent Living - Bukit Merah,42,19,1,23
30/6/2018,(DAC) TOUCH Centre for Independent Living - Ubi,50,37,4,13
31/7/2018,(DAC) BizLink Day Activity Centre,40,38,14,2
31/7/2018,(DAC) Eden Centre for Adults @ Clementi,40,39,11,1
31/7/2018,(DAC) Eden Centre for Adults @ Hougang,40,37,7,3
31/7/2018,(DAC) THK Day Activity Centre @ Chai Chee,50,21,2,29
31/7/2018,(DAC) THK Autism Centre @ Geylang Bahru,74,22,16,52
31/7/2018,(DAC) Bishan Home for the Intellectually Disabled,50,25,2,25
31/7/2018,(DAC) Blue Cross Thong Kheng ASD Day Activity Centre,62,15,3,47
31/7/2018,(DAC) Blue Cross Thong Kheng Home,50,33,1,17
31/7/2018,(DAC) Emmanuel Activity Centre @ Tampines,50,51,5,-1
31/7/2018,(DAC) Emmanuel Activity Centre @ Toa Payoh,83,50,6,33
31/7/2018,(DAC) Cerebral Palsy Alliance Singapore,50,50,7,0
31/7/2018,(DAC) Metta Home @ Hougang,40,35,4,5
31/7/2018,(DAC) Metta Home @ Woodlands,50,29,1,21
31/7/2018,(DAC) MINDS Training & Development Centre @ Ang Mo Kio,55,50,2,5
31/7/2018,(DAC) MINDS Training & Development Centre @ Clementi,55,45,0,10
31/7/2018,(DAC) MINDS Training & Development Centre @ Eunos,100,69,0,31
31/7/2018,(DAC) MINDS Training & Development Centre @ Faber,41,34,1,7
31/7/2018,(DAC) MINDS Training & Development Centre @ Jurong,53,42,3,11
31/7/2018,(DAC) MINDS Training & Development Centre @ Napiri,50,60,14,-10
31/7/2018,(DAC) MINDS Training & Development Centre @ Tampines,48,53,3,-5
31/7/2018,(DAC) MINDS Training & Development Centre @ Yishun,61,51,4,10
31/7/2018,(DAC) Red Cross Day Activity Centre,50,13,1,37
31/7/2018,(DAC) Singapore Cheshire Home,50,28,0,22
31/7/2018,(DAC) SPD Day Activity Centre,91,61,16,30
31/7/2018,(DAC) St Andrew's Autism Centre (Siglap),78,89,22,-11
31/7/2018,(DAC) SUN-DAC @ Bedok,50,45,1,5
31/7/2018,(DAC) SUN-DAC @ Choa Chu Kang,50,48,4,2
31/7/2018,(DAC) SUN-DAC @ Upper Thomson,120,10,13,110
31/7/2018,(DAC) TOUCH Centre for Independent Living - Bukit Merah,42,20,1,22
31/7/2018,(DAC) TOUCH Centre for Independent Living - Ubi,50,37,4,13
31/8/2018,(DAC) BizLink Day Activity Centre,40,38,13,2
30/8/2018,(DAC) Metta Home @ Hougang,40,35,4,5
31/8/2018,(DAC) Red Cross Day Activity Centre,50,13,1,37
31/8/2018,(DAC) SUN-DAC @ Bedok,50,45,1,5
31/8/2018,(DAC) SUN-DAC @ Upper Thomson,120,10,15,110
30/8/2018,(DAC) THK Autism Centre @ Geylang Bahru,66,20,13,46
31/8/2018,(DAC) Bishan Home for the Intellectually Disabled,50,25,2,25
31/8/2018,(DAC) Blue Cross Thong Kheng ASD Day Activity Centre,60,15,3,45
31/8/2018,(DAC) Blue Cross Thong Kheng Home,50,31,1,19
31/8/2018,(DAC) Emmanuel Activity Centre @ Tampines,50,51,5,-1
31/8/2018,(DAC) Emmanuel Activity Centre @ Toa Payoh,83,50,6,33
31/8/2018,(DAC) Cerebral Palsy Alliance Singapore,50,50,10,0
30/8/2018,(DAC) Metta Home @ Woodlands,50,29,1,21
31/8/2018,(DAC) MINDS Training & Development Centre @ Ang Mo Kio,55,48,2,7
31/8/2018,(DAC) MINDS Training & Development Centre @ Clementi,55,45,2,10
31/8/2018,(DAC) MINDS Training & Development Centre @ Eunos,100,69,0,31
31/8/2018,(DAC) MINDS Training & Development Centre @ Faber,41,33,0,8
31/8/2018,(DAC) MINDS Training & Development Centre @ Jurong,53,41,4,12
31/8/2018,(DAC) MINDS Training & Development Centre @ Napiri,50,59,13,-9
31/8/2018,(DAC) MINDS Training & Development Centre @ Tampines,48,53,4,-5
31/8/2018,(DAC) MINDS Training & Development Centre @ Yishun,61,51,3,10
31/8/2018,(DAC) Singapore Cheshire Home,50,27,0,23
31/8/2018,(DAC) SPD Day Activity Centre,91,62,16,29
31/8/2018,(DAC) St Andrew's Autism Centre (Siglap),97,89,17,8
31/8/2018,(DAC) SUN-DAC @ Choa Chu Kang,50,48,3,2
30/8/2018,(DAC) THK Day Activity Centre @ Chai Chee,50,21,2,29
30/8/2018,(DAC) TOUCH Centre for Independent Living - Bukit Merah,42,20,2,22
30/8/2018,(DAC) TOUCH Centre for Independent Living - Ubi,50,38,2,12
30/9/2018,(DAC) BizLink Day Activity Centre,40,32,12,8
30/9/2018,(DAC) Metta Home @ Hougang,40,35,3,5
30/9/2018,(DAC) SUN-DAC @ Upper Thomson,120,10,21,110
30/9/2018,(DAC) THK Autism Centre @ Geylang Bahru,66,20,20,46
30/9/2018,(DAC) Bishan Home for the Intellectually Disabled,50,25,2,25
30/9/2018,(DAC) Blue Cross Thong Kheng ASD Day Activity Centre,60,15,8,45
30/9/2018,(DAC) Blue Cross Thong Kheng Home,50,31,2,19
30/9/2018,(DAC) Emmanuel Activity Centre @ Tampines,50,52,4,-2
30/9/2018,(DAC) Emmanuel Activity Centre @ Toa Payoh,83,50,11,33
30/9/2018,(DAC) Cerebral Palsy Alliance Singapore,50,50,16,0
30/9/2018,(DAC) Eden Centre for Adults @ Clementi,40,39,9,1
30/9/2018,(DAC) Eden Centre for Adults @ Hougang,40,37,4,3
30/9/2018,(DAC) Metta Home @ Woodlands,50,29,1,21
30/9/2018,(DAC) MINDS Training & Development Centre @ Ang Mo Kio,55,48,3,7
30/9/2018,(DAC) MINDS Training & Development Centre @ Clementi,55,46,3,9
30/9/2018,(DAC) MINDS Training & Development Centre @ Eunos,100,69,3,31
30/9/2018,(DAC) MINDS Training & Development Centre @ Faber,41,33,2,8
30/9/2018,(DAC) MINDS Training & Development Centre @ Jurong,53,41,4,12
30/9/2018,(DAC) MINDS Training & Development Centre @ Napiri,50,59,14,-9
30/9/2018,(DAC) MINDS Training & Development Centre @ Tampines,48,52,8,-4
30/9/2018,(DAC) MINDS Training & Development Centre @ Yishun,61,52,7,9
30/9/2018,(DAC) Red Cross Day Activity Centre,50,13,1,37
30/9/2018,(DAC) Singapore Cheshire Home,50,27,3,23
30/9/2018,(DAC) SPD Day Activity Centre,91,70,17,21
30/9/2018,(DAC) St Andrew's Autism Centre (Siglap),97,89,18,8
30/9/2018,(DAC) SUN-DAC @ Bedok,50,45,3,5
30/9/2018,(DAC) SUN-DAC @ Choa Chu Kang,50,48,2,2
30/9/2018,(DAC) THK Day Activity Centre @ Chai Chee,50,20,1,30
30/9/2018,(DAC) TOUCH Centre for Independent Living - Bukit Merah,42,21,1,21
30/9/2018,(DAC) TOUCH Centre for Independent Living - Ubi,50,38,2,12
31/1/2019,(DAC) Metta Home @ Hougang,40,33,3,7
31/1/2019,(DAC) THK Day Activity Centre @ Chai Chee,50,21,4,29
31/1/2019,(DAC) Bishan Home for the Intellectually Disabled,50,25,0,25
31/1/2019,(DAC) BizLink Day Activity Centre,40,33,7,7
31/1/2019,(DAC) Blue Cross Thong Kheng ASD Day Activity Centre,60,21,3,39
31/1/2019,(DAC) Blue Cross Thong Kheng Home,50,31,3,19
31/1/2019,(DAC) Emmanuel Activity Centre @ Tampines,50,53,3,-3
31/1/2019,(DAC) Emmanuel Activity Centre @ Toa Payoh,83,52,12,31
31/1/2019,(DAC) Cerebral Palsy Alliance Singapore,50,50,17,0
31/1/2019,(DAC) Eden Centre for Adults @ Clementi,40,46,11,-6
31/1/2019,(DAC) Eden Centre for Adults @ Hougang,40,39,3,1
31/1/2019,(DAC) Metta Home @ Woodlands,50,29,1,21
31/1/2019,(DAC) MINDS Training & Development Centre @ Ang Mo Kio,55,47,3,8
31/1/2019,(DAC) MINDS Training & Development Centre @ Clementi,55,46,3,9
31/1/2019,(DAC) MINDS Training & Development Centre @ Eunos,100,70,3,30
31/1/2019,(DAC) MINDS Training & Development Centre @ Faber,41,36,6,5
31/1/2019,(DAC) MINDS Training & Development Centre @ Jurong,53,42,4,11
31/1/2019,(DAC) MINDS Training & Development Centre @ Napiri,50,59,10,-9
31/1/2019,(DAC) MINDS Training & Development Centre @ Tampines,48,55,7,-7
31/1/2019,(DAC) MINDS Training & Development Centre @ Yishun,61,55,1,6
31/1/2019,(DAC) Red Cross Day Activity Centre,50,9,5,41
31/1/2019,(DAC) Singapore Cheshire Home,50,26,1,24
31/1/2019,(DAC) SPD Day Activity Centre,91,82,10,9
31/1/2019,(DAC) St Andrew's Autism Centre (Siglap),97,89,17,8
31/1/2019,(DAC) SUN-DAC @ Bedok,50,46,1,4
31/1/2019,(DAC) SUN-DAC @ Choa Chu Kang,50,49,2,1
31/1/2019,(DAC) SUN-DAC @ Upper Thomson,120,26,14,94
31/1/2019,(DAC) THK Autism Centre @ Geylang Bahru,66,27,7,39
31/1/2019,(DAC) TOUCH Centre for Independent Living - Bukit Merah,42,21,2,21
31/1/2019,(DAC) TOUCH Centre for Independent Living - Ubi,50,38,2,12
31/10/2019,(DAC) THK Day Activity Centre @ Chai Chee,50,19,4,31
31/10/2019,(DAC) THK Autism Centre @ Geylang Bahru,66,23,9,43
31/10/2019,(DAC) Bishan Home for the Intellectually Disabled,50,24,1,26
31/10/2019,(DAC) BizLink Day Activity Centre,40,33,5,7
31/10/2019,(DAC) Blue Cross Thong Kheng Home,50,32,4,18
31/10/2019,(DAC) Emmanuel Activity Centre @ Tampines,50,50,3,0
31/10/2019,(DAC) Eden Centre for Adults @ Clementi,40,44,10,-4
31/10/2019,(DAC) Eden Centre for Adults @ Hougang,40,42,4,-2
31/10/2019,(DAC) Metta Home @ Woodlands,50,28,2,22
31/10/2019,(DAC) MINDS Training & Development Centre @ Clementi,55,48,4,7
31/10/2019,(DAC) MINDS Training & Development Centre @ Eunos,100,66,7,34
31/10/2019,(DAC) MINDS Training & Development Centre @ Faber,41,37,0,4
31/10/2019,(DAC) MINDS Training & Development Centre @ Jurong,53,43,2,10
31/10/2019,(DAC) MINDS Training & Development Centre @ Yishun,61,52,8,9
31/10/2019,(DAC) Red Cross Day Activity Centre,50,11,5,39
30/11/2019,(DAC) Bishan Home for the Intellectually Disabled,50,25,1,25
30/11/2019,(DAC) BizLink Day Activity Centre,40,33,5,7
30/11/2019,(DAC) Blue Cross Thong Kheng Home,50,32,4,18
30/11/2019,(DAC) Cerebral Palsy Alliance Singapore,70,63,7,7
30/11/2019,(DAC) Eden Centre for Adults @ Hougang,40,42,4,-2
30/11/2019,(DAC) Metta Home @ Woodlands,50,28,2,22
30/11/2019,(DAC) MINDS Training & Development Centre @ Clementi,55,48,4,7
30/11/2019,(DAC) MINDS Training & Development Centre @ Eunos,100,66,7,34
30/11/2019,(DAC) MINDS Training & Development Centre @ Jurong,53,43,2,10
30/11/2019,(DAC) MINDS Training & Development Centre @ Napiri,50,59,12,-9
30/11/2019,(DAC) Singapore Cheshire Home,50,26,3,24
30/11/2019,(DAC) St Andrew's Autism Centre (Siglap),97,67,10,30
30/11/2019,(DAC) SUN-DAC @ Bedok,50,44,3,6
30/11/2019,(DAC) SUN-DAC @ Upper Thomson,120,35,10,85
30/11/2019,(DAC) TOUCH Centre for Independent Living - Bukit Merah,42,22,2,20
30/11/2019,(DAC) TOUCH Centre for Independent Living - Ubi,50,37,0,13
31/12/2019,(DAC) THK Autism Centre @ Geylang Bahru,66,23,9,43
31/12/2019,(DAC) Bishan Home for the Intellectually Disabled,50,25,1,25
31/12/2019,(DAC) Emmanuel Activity Centre @ Tampines,50,50,3,0
31/12/2019,(DAC) Emmanuel Activity Centre @ Toa Payoh,83,51,13,32
31/12/2019,(DAC) Cerebral Palsy Alliance Singapore,70,63,7,7
31/12/2019,(DAC) Metta Home @ Woodlands,50,28,2,22
31/12/2019,(DAC) MINDS Training & Development Centre @ Ang Mo Kio,55,50,3,5
31/12/2019,(DAC) MINDS Training & Development Centre @ Clementi,55,48,4,7
31/12/2019,(DAC) MINDS Training & Development Centre @ Eunos,100,66,7,34
31/12/2019,(DAC) MINDS Training & Development Centre @ Faber,41,37,0,4
31/12/2019,(DAC) Red Cross Day Activity Centre,50,11,6,39
31/12/2019,(DAC) Singapore Cheshire Home,50,26,2,24
31/12/2019,(DAC) St Andrew's Autism Centre (Sengkang),50,28,7,22
31/12/2019,(DAC) SUN-DAC @ Choa Chu Kang,50,48,2,2
31/12/2019,(DAC) SUN-DAC @ Upper Thomson,120,35,11,85
31/12/2019,(DAC) TOUCH Centre for Independent Living - Bukit Merah,42,22,2,20
28/2/2019,(DAC) Metta Home @ Hougang,40,33,3,7
28/2/2019,(DAC) SUN-DAC @ Upper Thomson,120,26,14,94
28/2/2019,(DAC) THK Day Activity Centre @ Chai Chee,50,21,4,29
28/2/2019,(DAC) THK Autism Centre @ Geylang Bahru,66,27,4,39
28/2/2019,(DAC) Bishan Home for the Intellectually Disabled,50,25,0,25
28/2/2019,(DAC) BizLink Day Activity Centre,40,32,7,8
28/2/2019,(DAC) Blue Cross Thong Kheng ASD Day Activity Centre,60,21,3,39
28/2/2019,(DAC) Blue Cross Thong Kheng Home,50,31,3,19
28/2/2019,(DAC) Emmanuel Activity Centre @ Tampines,50,53,3,-3
28/2/2019,(DAC) Emmanuel Activity Centre @ Toa Payoh,83,51,14,32
28/2/2019,(DAC) Cerebral Palsy Alliance Singapore,50,50,18,0
28/2/2019,(DAC) Eden Centre for Adults @ Clementi,40,46,11,-6
28/2/2019,(DAC) Eden Centre for Adults @ Hougang,40,42,3,-2
28/2/2019,(DAC) Metta Home @ Woodlands,50,29,0,21
28/2/2019,(DAC) MINDS Training & Development Centre @ Ang Mo Kio,55,47,3,8
28/2/2019,(DAC) MINDS Training & Development Centre @ Clementi,55,47,3,8
28/2/2019,(DAC) MINDS Training & Development Centre @ Eunos,100,70,2,30
28/2/2019,(DAC) MINDS Training & Development Centre @ Faber,41,40,1,1
28/2/2019,(DAC) MINDS Training & Development Centre @ Jurong,53,43,4,10
28/2/2019,(DAC) MINDS Training & Development Centre @ Napiri,50,58,10,-8
28/2/2019,(DAC) MINDS Training & Development Centre @ Tampines,48,55,7,-7
28/2/2019,(DAC) MINDS Training & Development Centre @ Yishun,61,54,1,7
28/2/2019,(DAC) Red Cross Day Activity Centre,50,7,6,43
28/2/2019,(DAC) Singapore Cheshire Home,50,27,0,23
28/2/2019,(DAC) SPD Day Activity Centre,91,83,10,8
28/2/2019,(DAC) St Andrew's Autism Centre (Siglap),97,90,16,7
28/2/2019,(DAC) SUN-DAC @ Bedok,50,46,1,4
28/2/2019,(DAC) SUN-DAC @ Choa Chu Kang,50,49,2,1
28/2/2019,(DAC) TOUCH Centre for Independent Living - Bukit Merah,42,22,0,20
28/2/2019,(DAC) TOUCH Centre for Independent Living - Ubi,50,38,3,12
31/3/2019,(DAC) Metta Home @ Hougang,40,33,3,7
31/3/2019,(DAC) THK Day Activity Centre @ Chai Chee,50,21,5,29
31/3/2019,(DAC) THK Autism Centre @ Geylang Bahru,66,27,6,39
31/3/2019,(DAC) Bishan Home for the Intellectually Disabled,50,25,1,25
31/3/2019,(DAC) BizLink Day Activity Centre,40,35,5,5
31/3/2019,(DAC) Blue Cross Thong Kheng ASD Day Activity Centre,60,21,8,39
31/3/2019,(DAC) Blue Cross Thong Kheng Home,50,31,3,19
31/3/2019,(DAC) Emmanuel Activity Centre @ Tampines,50,53,4,-3
31/3/2019,(DAC) Emmanuel Activity Centre @ Toa Payoh,83,50,14,33
31/3/2019,(DAC) Cerebral Palsy Alliance Singapore,50,50,18,0
31/3/2019,(DAC) Eden Centre for Adults @ Clementi,40,43,11,-3
31/3/2019,(DAC) Eden Centre for Adults @ Hougang,40,41,5,-1
31/3/2019,(DAC) Metta Home @ Woodlands,50,28,0,22
31/3/2019,(DAC) MINDS Training & Development Centre @ Ang Mo Kio,55,48,2,7
31/3/2019,(DAC) MINDS Training & Development Centre @ Clementi,55,48,2,7
31/3/2019,(DAC) MINDS Training & Development Centre @ Eunos,100,70,2,30
31/3/2019,(DAC) MINDS Training & Development Centre @ Faber,41,41,1,0
31/3/2019,(DAC) MINDS Training & Development Centre @ Jurong,53,43,5,10
31/3/2019,(DAC) MINDS Training & Development Centre @ Napiri,50,58,9,-8
31/3/2019,(DAC) MINDS Training & Development Centre @ Tampines,48,56,6,-8
31/3/2019,(DAC) MINDS Training & Development Centre @ Yishun,61,55,0,6
31/3/2019,(DAC) Red Cross Day Activity Centre,50,7,6,43
31/3/2019,(DAC) Singapore Cheshire Home,50,26,0,24
31/3/2019,(DAC) SPD Day Activity Centre,91,85,9,6
31/3/2019,(DAC) St Andrew's Autism Centre (Siglap),97,65,16,32
31/3/2019,(DAC) SUN-DAC @ Bedok,50,47,0,3
31/3/2019,(DAC) SUN-DAC @ Choa Chu Kang,50,51,3,-1
31/3/2019,(DAC) SUN-DAC @ Upper Thomson,120,32,8,88
31/3/2019,(DAC) TOUCH Centre for Independent Living - Bukit Merah,42,22,0,20
31/3/2019,(DAC) TOUCH Centre for Independent Living - Ubi,50,38,2,12
30/4/2019,(DAC) BizLink Day Activity Centre,40,34,5,6
30/4/2019,(DAC) Metta Home @ Hougang,40,33,3,7
30/4/2019,(DAC) Bishan Home for the Intellectually Disabled,50,25,1,25
30/4/2019,(DAC) Blue Cross Thong Kheng ASD Day Activity Centre,60,21,5,39
30/4/2019,(DAC) Blue Cross Thong Kheng Home,50,32,2,18
30/4/2019,(DAC) Emmanuel Activity Centre @ Tampines,50,55,2,-5
30/4/2019,(DAC) Emmanuel Activity Centre @ Toa Payoh,83,50,14,33
30/4/2019,(DAC) Cerebral Palsy Alliance Singapore,50,50,19,0
30/4/2019,(DAC) Eden Centre for Adults @ Clementi,40,44,10,-4
30/4/2019,(DAC) Eden Centre for Adults @ Hougang,40,43,3,-3
30/4/2019,(DAC) Metta Home @ Woodlands,50,28,0,22
30/4/2019,(DAC) MINDS Training & Development Centre @ Ang Mo Kio,55,48,2,7
30/4/2019,(DAC) MINDS Training & Development Centre @ Clementi,55,49,1,6
30/4/2019,(DAC) MINDS Training & Development Centre @ Eunos,100,69,2,31
30/4/2019,(DAC) MINDS Training & Development Centre @ Faber,41,40,1,1
30/4/2019,(DAC) MINDS Training & Development Centre @ Jurong,53,43,6,10
30/4/2019,(DAC) MINDS Training & Development Centre @ Napiri,50,58,9,-8
30/4/2019,(DAC) MINDS Training & Development Centre @ Tampines,48,54,9,-6
30/4/2019,(DAC) MINDS Training & Development Centre @ Yishun,61,54,1,7
30/4/2019,(DAC) Red Cross Day Activity Centre,50,9,4,41
30/4/2019,(DAC) Singapore Cheshire Home,50,26,1,24
30/4/2019,(DAC) SPD Day Activity Centre,91,85,10,6
30/4/2019,(DAC) St Andrew's Autism Centre (Sengkang),50,25,0,25
30/4/2019,(DAC) St Andrew's Autism Centre (Siglap),97,65,14,32
30/4/2019,(DAC) SUN-DAC @ Bedok,50,44,0,6
30/4/2019,(DAC) SUN-DAC @ Choa Chu Kang,50,47,3,3
30/4/2019,(DAC) SUN-DAC @ Upper Thomson,120,32,6,88
30/4/2019,(DAC) THK Day Activity Centre @ Chai Chee,50,21,5,29
30/4/2019,(DAC) THK Autism Centre @ Geylang Bahru,66,26,3,40
30/4/2019,(DAC) TOUCH Centre for Independent Living - Bukit Merah,42,22,1,20
30/4/2019,(DAC) TOUCH Centre for Independent Living - Ubi,50,38,3,12
31/5/2019,(DAC) Metta Home @ Hougang,40,32,3,8
31/5/2019,(DAC) THK Day Activity Centre @ Chai Chee,50,21,5,29
31/5/2019,(DAC) Bishan Home for the Intellectually Disabled,50,25,2,25
31/5/2019,(DAC) BizLink Day Activity Centre,40,35,5,5
31/5/2019,(DAC) Blue Cross Thong Kheng ASD Day Activity Centre,60,21,5,39
31/5/2019,(DAC) Blue Cross Thong Kheng Home,50,31,3,19
31/5/2019,(DAC) Emmanuel Activity Centre @ Tampines,50,55,2,-5
31/5/2019,(DAC) Emmanuel Activity Centre @ Toa Payoh,83,50,13,33
31/5/2019,(DAC) Cerebral Palsy Alliance Singapore,50,50,21,0
31/5/2019,(DAC) Eden Centre for Adults @ Clementi,40,44,9,-4
31/5/2019,(DAC) Eden Centre for Adults @ Hougang,40,43,3,-3
31/5/2019,(DAC) Metta Home @ Woodlands,50,28,1,22
31/5/2019,(DAC) MINDS Training & Development Centre @ Ang Mo Kio,55,50,2,5
31/5/2019,(DAC) MINDS Training & Development Centre @ Clementi,55,49,1,6
31/5/2019,(DAC) MINDS Training & Development Centre @ Eunos,100,69,2,31
31/5/2019,(DAC) MINDS Training & Development Centre @ Faber,41,40,1,1
31/5/2019,(DAC) MINDS Training & Development Centre @ Jurong,53,46,3,7
31/5/2019,(DAC) MINDS Training & Development Centre @ Napiri,50,57,10,-7
31/5/2019,(DAC) MINDS Training & Development Centre @ Tampines,48,53,10,-5
31/5/2019,(DAC) MINDS Training & Development Centre @ Yishun,61,53,1,8
31/5/2019,(DAC) Red Cross Day Activity Centre,50,9,1,41
31/5/2019,(DAC) Singapore Cheshire Home,50,25,1,25
31/5/2019,(DAC) SPD Day Activity Centre,91,85,9,6
31/5/2019,(DAC) St Andrew's Autism Centre (Sengkang),50,25,0,25
31/5/2019,(DAC) St Andrew's Autism Centre (Siglap),97,65,14,32
31/5/2019,(DAC) SUN-DAC @ Bedok,50,43,0,7
31/5/2019,(DAC) SUN-DAC @ Choa Chu Kang,50,47,3,3
31/5/2019,(DAC) SUN-DAC @ Upper Thomson,120,33,3,87
31/5/2019,(DAC) THK Autism Centre @ Geylang Bahru,66,26,3,40
31/5/2019,(DAC) TOUCH Centre for Independent Living - Bukit Merah,42,22,0,20
31/5/2019,(DAC) TOUCH Centre for Independent Living - Ubi,50,39,0,11
30/6/2019,(DAC) BizLink Day Activity Centre,40,35,5,5
30/6/2019,(DAC) MINDS Training & Development Centre @ Napiri,50,57,11,-7
30/6/2019,(DAC) THK Autism Centre @ Geylang Bahru,66,25,3,41
30/6/2019,(DAC) Blue Cross Thong Kheng ASD Day Activity Centre,60,21,11,39
30/6/2019,(DAC) Eden Centre for Adults @ Hougang,40,42,3,-2
30/6/2019,(DAC) MINDS Training & Development Centre @ Clementi,55,49,0,6
30/6/2019,(DAC) MINDS Training & Development Centre @ Tampines,48,54,9,-6
30/6/2019,(DAC) St Andrew's Autism Centre (Sengkang),50,25,0,25
30/6/2019,(DAC) St Andrew's Autism Centre (Siglap),97,64,14,33
30/6/2019,(DAC) SUN-DAC @ Bedok,50,42,1,8
30/6/2019,(DAC) SUN-DAC @ Choa Chu Kang,50,47,3,3
30/6/2019,(DAC) TOUCH Centre for Independent Living - Bukit Merah,42,22,0,20
30/6/2019,(DAC) TOUCH Centre for Independent Living - Ubi,50,39,0,11
31/7/2019,(DAC) Metta Home @ Hougang,40,32,2,8
31/7/2019,(DAC) Bishan Home for the Intellectually Disabled,50,24,1,26
31/7/2019,(DAC) Blue Cross Thong Kheng Home,50,31,4,19
31/7/2019,(DAC) Eden Centre for Adults @ Clementi,40,44,9,-4
31/7/2019,(DAC) Metta Home @ Woodlands,50,28,2,22
31/7/2019,(DAC) MINDS Training & Development Centre @ Ang Mo Kio,55,51,1,4
31/7/2019,(DAC) MINDS Training & Development Centre @ Clementi,55,48,0,7
31/7/2019,(DAC) MINDS Training & Development Centre @ Eunos,100,69,2,31
31/7/2019,(DAC) MINDS Training & Development Centre @ Tampines,47,53,6,-6
31/7/2019,(DAC) MINDS Training & Development Centre @ Yishun,61,53,0,8
31/7/2019,(DAC) SPD Day Activity Centre,91,86,5,5
31/7/2019,(DAC) St Andrew's Autism Centre (Sengkang),50,25,5,25
31/7/2019,(DAC) SUN-DAC @ Bedok,50,42,3,8
31/7/2019,(DAC) SUN-DAC @ Upper Thomson,120,33,3,87
31/8/2019,(DAC) BizLink Day Activity Centre,40,36,4,4
31/8/2019,(DAC) Emmanuel Activity Centre @ Tampines,50,54,3,-4
31/8/2019,(DAC) Emmanuel Activity Centre @ Toa Payoh,83,50,14,33
31/8/2019,(DAC) Eden Centre for Adults @ Clementi,40,45,10,-5
31/8/2019,(DAC) Metta Home @ Hougang,40,32,1,8
31/8/2019,(DAC) Metta Home @ Woodlands,50,28,2,22
31/8/2019,(DAC) MINDS Training & Development Centre @ Ang Mo Kio,55,51,1,4
31/8/2019,(DAC) MINDS Training & Development Centre @ Jurong,53,44,2,9
31/8/2019,(DAC) MINDS Training & Development Centre @ Tampines,47,54,5,-7
31/8/2019,(DAC) MINDS Training & Development Centre @ Yishun,61,53,3,8
31/8/2019,(DAC) TOUCH Centre for Independent Living - Bukit Merah,42,22,1,20
30/9/2019,(DAC) THK Day Activity Centre @ Chai Chee,50,19,4,31
30/9/2019,(DAC) THK Autism Centre @ Geylang Bahru,66,23,9,43
30/9/2019,(DAC) Bishan Home for the Intellectually Disabled,50,24,1,26
30/9/2019,(DAC) BizLink Day Activity Centre,40,34,5,6
30/9/2019,(DAC) Emmanuel Activity Centre @ Tampines,50,52,3,-2
30/9/2019,(DAC) Emmanuel Activity Centre @ Toa Payoh,83,53,14,30
30/9/2019,(DAC) Metta Home @ Hougang,40,32,1,8
30/9/2019,(DAC) Metta Home @ Woodlands,50,28,2,22
30/9/2019,(DAC) MINDS Training & Development Centre @ Clementi,55,48,1,7
30/9/2019,(DAC) MINDS Training & Development Centre @ Eunos,100,67,6,33
30/9/2019,(DAC) MINDS Training & Development Centre @ Napiri,50,59,11,-9
30/9/2019,(DAC) Red Cross Day Activity Centre,50,10,5,40
30/9/2019,(DAC) SPD Day Activity Centre,91,87,3,4
30/9/2019,(DAC) St Andrew's Autism Centre (Sengkang),50,25,11,25
30/9/2019,(DAC) SUN-DAC @ Bedok,50,42,4,8
30/9/2019,(DAC) TOUCH Centre for Independent Living - Ubi,50,38,0,12
31/1/2020,(DAC) THK Autism Centre @ Geylang Bahru,66,23,8,43
31/1/2020,(DAC) Bishan Home for the Intellectually Disabled,50,25,1,25
31/1/2020,(DAC) BizLink Day Activity Centre,40,36,6,4
31/1/2020,(DAC) Blue Cross Thong Kheng ASD Day Activity Centre,60,41,7,19
31/1/2020,(DAC) Emmanuel Activity Centre @ Tampines,50,47,4,3
31/1/2020,(DAC) Eden Centre for Adults @ Clementi,40,44,9,-4
31/1/2020,(DAC) MINDS Training & Development Centre @ Ang Mo Kio,55,50,2,5
31/1/2020,(DAC) MINDS Training & Development Centre @ Jurong,53,45,1,8
31/1/2020,(DAC) MINDS Training & Development Centre @ Yishun,61,58,1,3
31/1/2020,(DAC) Singapore Cheshire Home,50,25,1,25
31/1/2020,(DAC) St Andrew's Autism Centre (Sengkang),50,28,8,22
31/1/2020,(DAC) SUN-DAC @ Upper Thomson,120,41,2,79
31/1/2020,(DAC) TOUCH Centre for Independent Living - Ubi,50,37,0,13
31/10/2020,(DAC) THK Day Activity Centre @ Chai Chee,50,18,6,32
31/10/2020,(DAC) THK Autism Centre @ Geylang Bahru,66,26,7,40
31/10/2020,(DAC) Bishan Home for the Intellectually Disabled,50,24,0,26
31/10/2020,(DAC) Blue Cross Thong Kheng ASD Day Activity Centre,60,34,14,26
31/10/2020,(DAC) Emmanuel Activity Centre @ Tampines,50,45,6,5
31/10/2020,(DAC) Emmanuel Activity Centre @ Toa Payoh,83,56,19,27
31/10/2020,(DAC) Metta Home @ Hougang,40,30,2,10
31/10/2020,(DAC) Metta Home @ Woodlands,50,28,1,22
31/10/2020,(DAC) MINDS Training & Development Centre @ Eunos,100,70,8,30
31/10/2020,(DAC) MINDS Training & Development Centre @ Yishun,61,62,3,-1
31/10/2020,(DAC) Singapore Cheshire Home,50,23,4,27
31/10/2020,(DAC) TOUCH Centre for Independent Living - Bukit Merah,42,24,3,18
31/10/2020,(DAC) TOUCH Centre for Independent Living - Ubi,50,37,1,13
30/11/2020,(DAC) SUN-DAC @ Upper Thomson,120,37,10,83
30/11/2020,(DAC) Blue Cross Thong Kheng ASD Day Activity Centre,60,34,14,26
30/11/2020,(DAC) Blue Cross Thong Kheng Home,50,31,1,19
30/11/2020,(DAC) MINDS Training & Development Centre @ Ang Mo Kio,55,48,8,7
30/11/2020,(DAC) MINDS Training & Development Centre @ Napiri,50,55,11,-5
30/11/2020,(DAC) MINDS Training & Development Centre @ Tampines,47,53,3,-6
30/11/2020,(DAC) Singapore Cheshire Home,50,22,4,28
30/11/2020,(DAC) SPD Day Activity Centre,91,85,8,6
31/12/2020,(DAC) Bishan Home for the Intellectually Disabled,50,24,0,26
31/12/2020,(DAC) BizLink Day Activity Centre,40,39,7,1
31/12/2020,(DAC) Blue Cross Thong Kheng ASD Day Activity Centre,60,32,13,28
31/12/2020,(DAC) Blue Cross Thong Kheng Home,50,31,1,19
31/12/2020,(DAC) Emmanuel Activity Centre @ Tampines,50,45,7,5
31/12/2020,(DAC) Eden Centre for Adults @ Hougang,40,44,8,-4
31/12/2020,(DAC) MINDS Training & Development Centre @ Jurong,53,48,10,5
31/12/2020,(DAC) MINDS Training & Development Centre @ Napiri,50,55,13,-5
31/12/2020,(DAC) Red Cross Day Activity Centre,50,14,4,36
31/12/2020,(DAC) Singapore Cheshire Home,50,22,5,28
31/12/2020,(DAC) SPD Day Activity Centre,91,86,6,5
31/12/2020,(DAC) St Andrew's Autism Centre (Sengkang),50,34,11,16
31/12/2020,(DAC) St Andrew's Autism Centre (Siglap),73,70,8,3
31/12/2020,(DAC) SUN-DAC @ Upper Thomson,120,39,9,81
31/12/2020,(DAC) TOUCH Centre for Independent Living - Ubi,50,37,1,13
29/2/2020,(DAC) THK Day Activity Centre @ Chai Chee,50,18,4,32
29/2/2020,(DAC) Bishan Home for the Intellectually Disabled,50,25,1,25
29/2/2020,(DAC) Emmanuel Activity Centre @ Tampines,50,46,4,4
29/2/2020,(DAC) MINDS Training & Development Centre @ Clementi,55,48,2,7
29/2/2020,(DAC) MINDS Training & Development Centre @ Faber,41,37,2,4
29/2/2020,(DAC) MINDS Training & Development Centre @ Jurong,53,45,1,8
29/2/2020,(DAC) MINDS Training & Development Centre @ Napiri,50,59,9,-9
29/2/2020,(DAC) MINDS Training & Development Centre @ Tampines,47,51,4,-4
29/2/2020,(DAC) MINDS Training & Development Centre @ Yishun,61,59,0,2
29/2/2020,(DAC) Singapore Cheshire Home,50,24,1,26
29/2/2020,(DAC) St Andrew's Autism Centre (Sengkang),50,28,9,22
29/2/2020,(DAC) SUN-DAC @ Choa Chu Kang,50,49,4,1
29/2/2020,(DAC) SUN-DAC @ Upper Thomson,120,42,1,78
29/2/2020,(DAC) TOUCH Centre for Independent Living - Ubi,50,37,0,13
31/3/2020,(DAC) BizLink Day Activity Centre,40,32,4,8
31/3/2020,(DAC) Blue Cross Thong Kheng ASD Day Activity Centre,60,40,8,20
31/3/2020,(DAC) Blue Cross Thong Kheng Home,50,34,1,16
31/3/2020,(DAC) Cerebral Palsy Alliance Singapore,70,67,0,3
31/3/2020,(DAC) Eden Centre for Adults @ Clementi,40,44,9,-4
31/3/2020,(DAC) MINDS Training & Development Centre @ Clementi,55,49,1,6
31/3/2020,(DAC) MINDS Training & Development Centre @ Faber,41,37,2,4
31/3/2020,(DAC) Singapore Cheshire Home,50,24,1,26
31/3/2020,(DAC) St Andrew's Autism Centre (Sengkang),50,31,8,19
31/3/2020,(DAC) SUN-DAC @ Upper Thomson,120,42,1,78
31/3/2020,(DAC) TOUCH Centre for Independent Living - Bukit Merah,42,23,0,19
31/3/2020,(DAC) TOUCH Centre for Independent Living - Ubi,50,37,0,13
30/4/2020,(DAC) Bishan Home for the Intellectually Disabled,50,24,1,26
30/4/2020,(DAC) Blue Cross Thong Kheng ASD Day Activity Centre,60,41,7,19
30/4/2020,(DAC) Blue Cross Thong Kheng Home,50,34,1,16
30/4/2020,(DAC) Emmanuel Activity Centre @ Tampines,50,46,4,4
30/4/2020,(DAC) MINDS Training & Development Centre @ Ang Mo Kio,55,50,1,5
30/4/2020,(DAC) MINDS Training & Development Centre @ Eunos,100,71,1,29
30/4/2020,(DAC) MINDS Training & Development Centre @ Jurong,53,45,3,8
30/4/2020,(DAC) MINDS Training & Development Centre @ Napiri,50,59,8,-9
30/4/2020,(DAC) MINDS Training & Development Centre @ Tampines,47,51,3,-4
30/4/2020,(DAC) MINDS Training & Development Centre @ Yishun,61,59,0,2
30/4/2020,(DAC) Red Cross Day Activity Centre,50,12,2,38
30/4/2020,(DAC) St Andrew's Autism Centre (Sengkang),50,32,7,18
30/4/2020,(DAC) St Andrew's Autism Centre (Siglap),97,69,4,28
30/4/2020,(DAC) SUN-DAC @ Choa Chu Kang,50,49,3,1
30/4/2020,(DAC) SUN-DAC @ Upper Thomson,120,40,0,80
31/5/2020,(DAC) Emmanuel Activity Centre @ Toa Payoh,83,55,14,28
31/5/2020,(DAC) Bishan Home for the Intellectually Disabled,50,24,1,26
31/5/2020,(DAC) BizLink Day Activity Centre,40,37,2,3
31/5/2020,(DAC) Cerebral Palsy Alliance Singapore,70,67,0,3
31/5/2020,(DAC) Eden Centre for Adults @ Hougang,40,44,3,-4
31/5/2020,(DAC) Metta Home @ Woodlands,50,29,3,21
31/5/2020,(DAC) MINDS Training & Development Centre @ Clementi,55,49,1,6
31/5/2020,(DAC) MINDS Training & Development Centre @ Eunos,100,71,1,29
31/5/2020,(DAC) MINDS Training & Development Centre @ Faber,41,38,1,3
31/5/2020,(DAC) MINDS Training & Development Centre @ Jurong,53,45,3,8
31/5/2020,(DAC) MINDS Training & Development Centre @ Napiri,50,59,8,-9
31/5/2020,(DAC) MINDS Training & Development Centre @ Tampines,47,51,3,-4
31/5/2020,(DAC) MINDS Training & Development Centre @ Yishun,61,59,0,2
31/5/2020,(DAC) Red Cross Day Activity Centre,50,12,2,38
31/5/2020,(DAC) SPD Day Activity Centre,91,84,3,7
31/5/2020,(DAC) TOUCH Centre for Independent Living - Bukit Merah,42,22,0,20
30/6/2020,(DAC) THK Autism Centre @ Geylang Bahru,66,29,3,37
30/6/2020,(DAC) Emmanuel Activity Centre @ Toa Payoh,83,55,14,28
30/6/2020,(DAC) Cerebral Palsy Alliance Singapore,70,67,0,3
30/6/2020,(DAC) Eden Centre for Adults @ Hougang,40,44,3,-4
30/6/2020,(DAC) Metta Home @ Hougang,40,32,1,8
30/6/2020,(DAC) MINDS Training & Development Centre @ Yishun,61,59,2,2
30/6/2020,(DAC) SPD Day Activity Centre,91,82,3,9
30/6/2020,(DAC) St Andrew's Autism Centre (Siglap),73,69,5,4
30/6/2020,(DAC) SUN-DAC @ Upper Thomson,120,39,0,81
30/6/2020,(DAC) TOUCH Centre for Independent Living - Ubi,50,36,0,14
31/7/2020,(DAC) Bishan Home for the Intellectually Disabled,50,24,0,26
31/7/2020,(DAC) Blue Cross Thong Kheng ASD Day Activity Centre,60,41,12,19
31/7/2020,(DAC) Blue Cross Thong Kheng Home,50,33,1,17
31/7/2020,(DAC) Emmanuel Activity Centre @ Toa Payoh,83,55,17,28
31/7/2020,(DAC) Metta Home @ Hougang,40,32,3,8
31/7/2020,(DAC) Metta Home @ Woodlands,50,28,2,22
31/7/2020,(DAC) MINDS Training & Development Centre @ Clementi,55,49,3,6
31/7/2020,(DAC) MINDS Training & Development Centre @ Napiri,50,56,10,-6
31/7/2020,(DAC) MINDS Training & Development Centre @ Tampines,47,52,4,-5
31/7/2020,(DAC) Red Cross Day Activity Centre,50,12,6,38
31/7/2020,(DAC) St Andrew's Autism Centre (Sengkang),50,32,13,18
31/7/2020,(DAC) SUN-DAC @ Bedok,50,45,3,5
31/7/2020,(DAC) SUN-DAC @ Upper Thomson,120,39,6,81
31/7/2020,(DAC) THK Day Activity Centre @ Chai Chee,50,17,6,33
31/7/2020,(DAC) TOUCH Centre for Independent Living - Bukit Merah,42,22,2,20
31/8/2020,(DAC) BizLink Day Activity Centre,40,37,6,3
31/8/2020,(DAC) Emmanuel Activity Centre @ Tampines,50,45,6,5
31/8/2020,(DAC) Emmanuel Activity Centre @ Toa Payoh,83,56,19,27
31/8/2020,(DAC) Cerebral Palsy Alliance Singapore,70,66,1,4
31/8/2020,(DAC) Eden Centre for Adults @ Clementi,40,44,15,-4
31/8/2020,(DAC) Metta Home @ Hougang,40,32,3,8
31/8/2020,(DAC) Metta Home @ Woodlands,50,28,2,22
31/8/2020,(DAC) MINDS Training & Development Centre @ Clementi,55,48,3,7
31/8/2020,(DAC) MINDS Training & Development Centre @ Eunos,100,69,7,31
31/8/2020,(DAC) MINDS Training & Development Centre @ Yishun,61,59,6,2
31/8/2020,(DAC) Red Cross Day Activity Centre,50,12,7,38
31/8/2020,(DAC) SUN-DAC @ Upper Thomson,120,39,6,81
31/8/2020,(DAC) TOUCH Centre for Independent Living - Bukit Merah,42,22,4,20
31/8/2020,(DAC) TOUCH Centre for Independent Living - Ubi,50,36,0,14
30/9/2020,(DAC) Bishan Home for the Intellectually Disabled,50,24,0,26
30/9/2020,(DAC) BizLink Day Activity Centre,40,39,6,1
30/9/2020,(DAC) Emmanuel Activity Centre @ Toa Payoh,83,56,19,27
30/9/2020,(DAC) Eden Centre for Adults @ Hougang,40,44,7,-4
30/9/2020,(DAC) Metta Home @ Hougang,40,32,2,8
30/9/2020,(DAC) Metta Home @ Woodlands,50,28,2,22
30/9/2020,(DAC) MINDS Training & Development Centre @ Clementi,55,48,3,7
30/9/2020,(DAC) MINDS Training & Development Centre @ Napiri,50,56,13,-6
30/9/2020,(DAC) SPD Day Activity Centre,91,82,9,9
30/9/2020,(DAC) St Andrew's Autism Centre (Sengkang),50,33,17,17
30/9/2020,(DAC) St Andrew's Autism Centre (Siglap),73,68,10,5
30/9/2020,(DAC) SUN-DAC @ Choa Chu Kang,50,50,5,0
30/9/2020,(DAC) THK Autism Centre @ Geylang Bahru,66,27,5,39
30/9/2020,(DAC) TOUCH Centre for Independent Living - Bukit Merah,42,23,3,19
31/1/2021,(DAC) Bishan Home for the Intellectually Disabled,50,24,0,26
31/1/2021,(DAC) Blue Cross Thong Kheng ASD Day Activity Centre,60,41,4,19
31/1/2021,(DAC) Emmanuel Activity Centre @ Tampines,50,45,7,5
31/1/2021,(DAC) Emmanuel Activity Centre @ Toa Payoh,83,56,18,27
31/1/2021,(DAC) Cerebral Palsy Alliance Singapore,70,64,1,6
31/1/2021,(DAC) Eden Centre for Adults @ Clementi,40,44,18,-4
31/1/2021,(DAC) Eden Centre for Adults @ Hougang,40,44,8,-4
31/1/2021,(DAC) Metta Home @ Hougang,40,32,0,8
31/1/2021,(DAC) Metta Home @ Woodlands,50,28,2,22
31/1/2021,(DAC) MINDS Training & Development Centre @ Ang Mo Kio,55,51,3,4
31/1/2021,(DAC) MINDS Training & Development Centre @ Clementi,55,50,6,5
31/1/2021,(DAC) MINDS Training & Development Centre @ Jurong,53,49,11,4
31/1/2021,(DAC) MINDS Training & Development Centre @ Napiri,50,57,10,-7
31/1/2021,(DAC) MINDS Training & Development Centre @ Tampines,47,53,2,-6
31/1/2021,(DAC) MINDS Training & Development Centre @ Yishun,61,63,0,-2
31/1/2021,(DAC) Red Cross Day Activity Centre,50,15,1,35
31/1/2021,(DAC) Singapore Cheshire Home,50,23,4,27
31/1/2021,(DAC) St Andrew's Autism Centre (Sengkang),50,41,5,9
31/1/2021,(DAC) SUN-DAC @ Choa Chu Kang,50,51,3,-1
31/1/2021,(DAC) SUN-DAC @ Upper Thomson,120,40,5,80
31/1/2021,(DAC) THK Day Activity Centre @ Chai Chee,50,19,5,31
31/1/2021,(DAC) THK Autism Centre @ Geylang Bahru,66,26,7,40
31/1/2021,(DAC) TOUCH Centre for Independent Living - Ubi,50,37,3,13
31/10/2021,(DAC) BizLink Day Activity Centre,40,38,3,2
31/10/2021,(DAC) Blue Cross Thong Kheng ASD Day Activity Centre,60,34,13,26
31/10/2021,(DAC) Blue Cross Thong Kheng Home,50,31,1,19
31/10/2021,(DAC) Emmanuel Activity Centre @ Toa Payoh,83,60,19,23
31/10/2021,(DAC) Metta Home @ Hougang,40,32,2,8
31/10/2021,(DAC) Metta Home @ Woodlands,50,29,4,21
31/10/2021,(DAC) MINDS Training & Development Centre @ Ang Mo Kio,55,52,4,3
31/10/2021,(DAC) MINDS Training & Development Centre @ Eunos,100,76,4,24
31/10/2021,(DAC) MINDS Training & Development Centre @ Jurong,53,52,18,1
31/10/2021,(DAC) MINDS Training & Development Centre @ Napiri,50,57,11,-7
31/10/2021,(DAC) MINDS Training & Development Centre @ Yishun,61,62,4,-1
31/10/2021,(DAC) Red Cross Day Activity Centre,50,15,5,35
31/10/2021,(DAC) Singapore Cheshire Home,50,24,1,26
31/10/2021,(DAC) SPD Day Activity Centre,91,85,7,6
31/10/2021,(DAC) St Andrew's Autism Centre (Sengkang),50,40,9,10
31/10/2021,(DAC) THK Day Activity Centre @ Chai Chee,50,21,4,29
31/10/2021,(DAC) THK Autism Centre @ Geylang Bahru,66,30,6,36
30/11/2021,(DAC) Emmanuel Activity Centre @ Tampines,50,48,7,2
30/11/2021,(DAC) BizLink Day Activity Centre,40,38,5,2
30/11/2021,(DAC) Blue Cross Thong Kheng ASD Day Activity Centre,60,35,12,25
30/11/2021,(DAC) Cerebral Palsy Alliance Singapore,70,62,6,8
30/11/2021,(DAC) Eden Centre for Adults @ Clementi,40,44,20,-4
30/11/2021,(DAC) Metta Home @ Hougang,40,31,4,9
30/11/2021,(DAC) Metta Home @ Woodlands,50,29,4,21
30/11/2021,(DAC) MINDS Training & Development Centre @ Ang Mo Kio,55,51,3,4
30/11/2021,(DAC) MINDS Training & Development Centre @ Clementi,55,55,9,0
30/11/2021,(DAC) MINDS Training & Development Centre @ Jurong,53,52,18,1
30/11/2021,(DAC) MINDS Training & Development Centre @ Tampines,47,50,4,-3
30/11/2021,(DAC) MINDS Training & Development Centre @ Yishun,61,62,6,-1
30/11/2021,(DAC) Red Cross Day Activity Centre,50,16,7,34
30/11/2021,(DAC) SPD Day Activity Centre,91,85,8,6
30/11/2021,(DAC) St Andrew's Autism Centre (Sengkang),50,40,12,10
30/11/2021,(DAC) St Andrew's Autism Centre (Siglap),73,71,8,2
30/11/2021,(DAC) SUN-DAC @ Bedok,50,43,7,7
30/11/2021,(DAC) TOUCH Centre for Independent Living - Ubi,50,39,5,11
31/12/2021,(DAC) Blue Cross Thong Kheng ASD Day Activity Centre,60,35,14,25
31/12/2021,(DAC) Emmanuel Activity Centre @ Toa Payoh,50,54,20,-4
31/12/2021,(DAC) Cerebral Palsy Alliance Singapore,70,62,9,8
31/12/2021,(DAC) Eden Centre for Adults @ Hougang,50,33,6,17
31/12/2021,(DAC) SUN-DAC @ Bedok,50,41,4,9
31/12/2021,(DAC) SUN-DAC @ Choa Chu Kang,50,46,6,4
31/12/2021,(DAC) THK Day Activity Centre @ Chai Chee,50,20,4,30
31/12/2021,(DAC) THK Autism Centre @ Geylang Bahru,50,25,9,25
31/12/2021,(DAC) Blue Cross Thong Kheng Home,50,30,1,20
31/12/2021,(DAC) Metta Home @ Hougang,40,32,2,8
31/12/2021,(DAC) Metta Home @ Woodlands,50,29,4,21
31/12/2021,(DAC) MINDS Training & Development Centre @ Ang Mo Kio,55,49,3,6
31/12/2021,(DAC) MINDS Training & Development Centre @ Clementi,55,55,10,0
31/12/2021,(DAC) MINDS Training & Development Centre @ Eunos,100,75,5,25
31/12/2021,(DAC) MINDS Training & Development Centre @ Jurong,53,52,19,1
31/12/2021,(DAC) MINDS Training & Development Centre @ Tampines,47,50,4,-3
31/12/2021,(DAC) MINDS Training & Development Centre @ Yishun,61,62,7,-1
31/12/2021,(DAC) SPD Day Activity Centre,91,85,8,6
31/12/2021,(DAC) St Andrew's Autism Centre (Siglap),97,71,9,26
28/2/2021,(DAC) Bishan Home for the Intellectually Disabled,50,24,0,26
28/2/2021,(DAC) BizLink Day Activity Centre,40,39,9,1
28/2/2021,(DAC) Blue Cross Thong Kheng ASD Day Activity Centre,60,41,4,19
28/2/2021,(DAC) Blue Cross Thong Kheng Home,50,31,1,19
28/2/2021,(DAC) Eden Centre for Adults @ Clementi,40,44,18,-4
28/2/2021,(DAC) Eden Centre for Adults @ Hougang,40,44,8,-4
28/2/2021,(DAC) MINDS Training & Development Centre @ Clementi,55,51,6,4
28/2/2021,(DAC) MINDS Training & Development Centre @ Jurong,53,49,12,4
28/2/2021,(DAC) MINDS Training & Development Centre @ Tampines,47,53,3,-6
28/2/2021,(DAC) SUN-DAC @ Choa Chu Kang,50,51,3,-1
28/2/2021,(DAC) SUN-DAC @ Upper Thomson,120,41,4,79
28/2/2021,(DAC) THK Day Activity Centre @ Chai Chee,50,20,3,30
31/3/2021,(DAC) Bishan Home for the Intellectually Disabled,50,24,0,26
31/3/2021,(DAC) BizLink Day Activity Centre,40,38,2,2
31/3/2021,(DAC) Eden Centre for Adults @ Hougang,40,44,8,-4
31/3/2021,(DAC) Metta Home @ Hougang,40,32,2,8
31/3/2021,(DAC) MINDS Training & Development Centre @ Ang Mo Kio,55,51,4,4
31/3/2021,(DAC) MINDS Training & Development Centre @ Faber,41,44,6,-3
31/3/2021,(DAC) MINDS Training & Development Centre @ Jurong,53,50,15,3
31/3/2021,(DAC) Red Cross Day Activity Centre,50,15,3,35
31/3/2021,(DAC) THK Day Activity Centre @ Chai Chee,50,20,4,30
31/3/2021,(DAC) THK Autism Centre @ Geylang Bahru,66,28,8,38
30/4/2021,(DAC) Bishan Home for the Intellectually Disabled,50,24,0,26
30/4/2021,(DAC) BizLink Day Activity Centre,40,40,1,0
30/4/2021,(DAC) Blue Cross Thong Kheng ASD Day Activity Centre,60,37,5,23
30/4/2021,(DAC) Blue Cross Thong Kheng Home,50,31,1,19
30/4/2021,(DAC) Emmanuel Activity Centre @ Tampines,50,45,5,5
30/4/2021,(DAC) Cerebral Palsy Alliance Singapore,70,64,1,6
30/4/2021,(DAC) Metta Home @ Woodlands,50,29,2,21
30/4/2021,(DAC) MINDS Training & Development Centre @ Ang Mo Kio,55,50,5,5
30/4/2021,(DAC) MINDS Training & Development Centre @ Clementi,55,52,5,3
30/4/2021,(DAC) MINDS Training & Development Centre @ Eunos,100,77,1,23
30/4/2021,(DAC) MINDS Training & Development Centre @ Faber,41,45,5,-4
30/4/2021,(DAC) MINDS Training & Development Centre @ Napiri,50,58,8,-8
30/4/2021,(DAC) Singapore Cheshire Home,50,26,0,24
30/4/2021,(DAC) SPD Day Activity Centre,91,87,6,4
30/4/2021,(DAC) St Andrew's Autism Centre (Sengkang),50,42,6,8
30/4/2021,(DAC) St Andrew's Autism Centre (Siglap),73,73,4,0
30/4/2021,(DAC) SUN-DAC @ Bedok,50,44,2,6
30/4/2021,(DAC) SUN-DAC @ Upper Thomson,120,42,6,78
30/4/2021,(DAC) THK Day Activity Centre @ Chai Chee,50,20,5,30
31/5/2021,(DAC) BizLink Day Activity Centre,40,41,1,-1
31/5/2021,(DAC) Bishan Home for the Intellectually Disabled,50,24,0,26
31/5/2021,(DAC) Blue Cross Thong Kheng Home,50,31,1,19
31/5/2021,(DAC) Cerebral Palsy Alliance Singapore,70,64,1,6
31/5/2021,(DAC) Eden Centre for Adults @ Hougang,40,44,8,-4
31/5/2021,(DAC) Metta Home @ Hougang,40,32,3,8
31/5/2021,(DAC) MINDS Training & Development Centre @ Eunos,100,76,1,24
31/5/2021,(DAC) MINDS Training & Development Centre @ Faber,41,46,5,-5
31/5/2021,(DAC) St Andrew's Autism Centre (Sengkang),50,42,5,8
31/5/2021,(DAC) St Andrew's Autism Centre (Siglap),73,74,3,-1
31/5/2021,(DAC) SUN-DAC @ Bedok,50,44,1,6
31/5/2021,(DAC) THK Day Activity Centre @ Chai Chee,50,21,3,29
31/5/2021,(DAC) TOUCH Centre for Independent Living - Bukit Merah,42,25,0,17
31/5/2021,(DAC) TOUCH Centre for Independent Living - Ubi,50,39,4,11
30/6/2021,(DAC) Bishan Home for the Intellectually Disabled,50,24,0,26
30/6/2021,(DAC) Blue Cross Thong Kheng ASD Day Activity Centre,60,36,6,24
30/6/2021,(DAC) Blue Cross Thong Kheng Home,50,31,1,19
30/6/2021,(DAC) Emmanuel Activity Centre @ Tampines,50,45,5,5
30/6/2021,(DAC) Cerebral Palsy Alliance Singapore,70,64,1,6
30/6/2021,(DAC) Eden Centre for Adults @ Clementi,40,44,19,-4
30/6/2021,(DAC) Eden Centre for Adults @ Hougang,40,44,8,-4
30/6/2021,(DAC) MINDS Training & Development Centre @ Ang Mo Kio,55,52,3,3
30/6/2021,(DAC) MINDS Training & Development Centre @ Eunos,100,76,1,24
30/6/2021,(DAC) MINDS Training & Development Centre @ Napiri,50,57,9,-7
30/6/2021,(DAC) MINDS Training & Development Centre @ Tampines,47,53,3,-6
30/6/2021,(DAC) Singapore Cheshire Home,50,26,0,24
30/6/2021,(DAC) St Andrew's Autism Centre (Siglap),97,72,3,25
30/6/2021,(DAC) SUN-DAC @ Choa Chu Kang,50,49,2,1
30/6/2021,(DAC) THK Day Activity Centre @ Chai Chee,50,21,2,29
30/6/2021,(DAC) THK Autism Centre @ Geylang Bahru,66,28,7,38
30/6/2021,(DAC) TOUCH Centre for Independent Living - Bukit Merah,42,25,0,17
30/6/2021,(DAC) TOUCH Centre for Independent Living - Ubi,50,39,4,11
31/7/2021,(DAC) Bishan Home for the Intellectually Disabled,50,24,0,26
31/7/2021,(DAC) Emmanuel Activity Centre @ Tampines,50,45,6,5
31/7/2021,(DAC) Emmanuel Activity Centre @ Toa Payoh,83,57,17,26
31/7/2021,(DAC) Cerebral Palsy Alliance Singapore,70,64,1,6
31/7/2021,(DAC) Eden Centre for Adults @ Clementi,40,44,19,-4
31/7/2021,(DAC) Eden Centre for Adults @ Hougang,40,44,7,-4
31/7/2021,(DAC) Metta Home @ Hougang,40,32,1,8
31/7/2021,(DAC) Metta Home @ Woodlands,50,29,4,21
31/7/2021,(DAC) MINDS Training & Development Centre @ Eunos,100,76,1,24
31/7/2021,(DAC) MINDS Training & Development Centre @ Faber,41,46,5,-5
31/7/2021,(DAC) MINDS Training & Development Centre @ Jurong,53,53,14,0
31/7/2021,(DAC) MINDS Training & Development Centre @ Tampines,47,52,3,-5
31/7/2021,(DAC) SPD Day Activity Centre,91,86,6,5
31/7/2021,(DAC) St Andrew's Autism Centre (Siglap),73,72,3,1
31/7/2021,(DAC) SUN-DAC @ Choa Chu Kang,50,49,2,1
31/7/2021,(DAC) SUN-DAC @ Upper Thomson,120,45,6,75
31/7/2021,(DAC) THK Day Activity Centre @ Chai Chee,50,22,2,28
31/7/2021,(DAC) THK Autism Centre @ Geylang Bahru,66,30,6,36
31/7/2021,(DAC) TOUCH Centre for Independent Living - Bukit Merah,42,25,0,17
31/7/2021,(DAC) TOUCH Centre for Independent Living - Ubi,50,40,3,10
31/8/2021,(DAC) Blue Cross Thong Kheng Home,50,31,1,19
31/8/2021,(DAC) Emmanuel Activity Centre @ Toa Payoh,83,60,17,23
31/8/2021,(DAC) Eden Centre for Adults @ Clementi,40,44,19,-4
31/8/2021,(DAC) Metta Home @ Woodlands,50,29,3,21
31/8/2021,(DAC) MINDS Training & Development Centre @ Eunos,100,76,2,24
31/8/2021,(DAC) MINDS Training & Development Centre @ Napiri,50,57,9,-7
31/8/2021,(DAC) MINDS Training & Development Centre @ Yishun,61,62,2,-1
31/8/2021,(DAC) SPD Day Activity Centre,91,85,7,6
31/8/2021,(DAC) St Andrew's Autism Centre (Sengkang),50,41,5,9
31/8/2021,(DAC) St Andrew's Autism Centre (Siglap),73,71,3,2
31/8/2021,(DAC) SUN-DAC @ Choa Chu Kang,50,49,3,1
31/8/2021,(DAC) SUN-DAC @ Upper Thomson,120,45,7,75
31/8/2021,(DAC) THK Autism Centre @ Geylang Bahru,66,30,6,36
31/8/2021,(DAC) TOUCH Centre for Independent Living - Bukit Merah,42,26,1,16
31/8/2021,(DAC) TOUCH Centre for Independent Living - Ubi,50,40,4,10
30/9/2021,(DAC) Blue Cross Thong Kheng Home,50,31,1,19
30/9/2021,(DAC) Eden Centre for Adults @ Clementi,40,44,20,-4
30/9/2021,(DAC) MINDS Training & Development Centre @ Ang Mo Kio,55,53,2,2
30/9/2021,(DAC) MINDS Training & Development Centre @ Clementi,55,55,2,0
30/9/2021,(DAC) MINDS Training & Development Centre @ Faber,41,46,8,-5
30/9/2021,(DAC) MINDS Training & Development Centre @ Jurong,53,52,14,1
30/9/2021,(DAC) MINDS Training & Development Centre @ Tampines,47,52,2,-5
30/9/2021,(DAC) MINDS Training & Development Centre @ Yishun,61,62,3,-1
30/9/2021,(DAC) Singapore Cheshire Home,50,24,1,26
30/9/2021,(DAC) SPD Day Activity Centre,91,85,7,6
30/9/2021,(DAC) St Andrew's Autism Centre (Sengkang),50,41,8,9
30/9/2021,(DAC) SUN-DAC @ Choa Chu Kang,50,50,3,0
30/9/2021,(DAC) SUN-DAC @ Upper Thomson,120,47,4,73
30/9/2021,(DAC) THK Day Activity Centre @ Chai Chee,50,22,3,28
30/9/2021,(DAC) THK Autism Centre @ Geylang Bahru,66,30,6,36
30/9/2021,(DAC) TOUCH Centre for Independent Living - Bukit Merah,42,26,1,16
31/1/2022,(DAC) Emmanuel Activity Centre @ Tampines,50,48,5,2
31/1/2022,(DAC) Cerebral Palsy Alliance Singapore,70,66,4,4
31/1/2022,(DAC) Eden Centre for Adults @ Clementi,40,44,20,-4
31/1/2022,(DAC) Eden Centre for Adults @ Hougang,40,44,6,-4
31/1/2022,(DAC) Metta Home @ Hougang,40,32,2,8
31/1/2022,(DAC) MINDS Training & Development Centre @ Clementi,55,55,10,0
31/1/2022,(DAC) MINDS Training & Development Centre @ Eunos,100,76,4,24
31/1/2022,(DAC) MINDS Training & Development Centre @ Napiri,50,56,13,-6
31/1/2022,(DAC) MINDS Training & Development Centre @ Tampines,47,50,3,-3
31/1/2022,(DAC) MINDS Training & Development Centre @ Yishun,61,60,7,1
31/1/2022,(DAC) Singapore Cheshire Home,50,24,0,26
31/1/2022,(DAC) St Andrew's Autism Centre (Siglap),73,75,5,-2
31/1/2022,(DAC) SUN-DAC @ Upper Thomson,120,48,19,72
31/1/2022,(DAC) THK Day Activity Centre @ Chai Chee,50,21,5,29
31/1/2022,(DAC) THK Autism Centre @ Geylang Bahru,66,30,9,36
31/1/2022,(DAC) TOUCH Centre for Independent Living - Bukit Merah,42,27,2,15
31/1/2019,(SW) APSN Centre for Adults,170,133,3,37
31/1/2019,(SW) BizLink Sheltered Workshop,136,71,17,65
31/1/2019,(SW) Cerebral Palsy Alliance Singapore GROW,100,86,11,14
31/1/2019,(SW) MINDS IDEA Employment Development Centre,300,291,3,9
31/1/2019,(SW) SIA-MINDS Employment Development Centre,350,379,5,-29
31/1/2019,(SW) MINDS Woodlands Employment Development Centre,400,361,11,39
31/1/2019,(SW) SPD Sheltered Workshop,145,137,10,8
31/1/2019,(SW) THK-Pan-Disability Centre,100,75,5,25
31/10/2019,(SW) APSN Centre for Adults,170,163,17,7
31/10/2019,(SW) MINDS IDEA Employment Development Centre,300,298,6,2
31/10/2019,(SW) SIA-MINDS Employment Development Centre,350,371,21,-21
31/10/2019,(SW) SPD Sheltered Workshop,145,143,12,2
30/11/2019,(SW) SIA-MINDS Employment Development Centre,350,368,24,-18
30/11/2019,(SW) SPD Sheltered Workshop,145,134,12,11
30/11/2019,(SW) THK-Pan-Disability Centre,100,82,11,18
31/12/2019,(SW) APSN Centre for Adults,170,161,16,9
31/12/2019,(SW) SIA-MINDS Employment Development Centre,350,371,21,-21
28/2/2019,(SW) APSN Centre for Adults,170,149,1,21
28/2/2019,(SW) BizLink Sheltered Workshop,136,153,18,-17
28/2/2019,(SW) Cerebral Palsy Alliance Singapore GROW,100,86,8,14
28/2/2019,(SW) MINDS IDEA Employment Development Centre,300,300,3,0
28/2/2019,(SW) SIA-MINDS Employment Development Centre,350,380,6,-30
28/2/2019,(SW) MINDS Woodlands Employment Development Centre,400,361,4,39
28/2/2019,(SW) SPD Sheltered Workshop,145,137,5,8
28/2/2019,(SW) THK-Pan-Disability Centre,100,74,7,26
31/3/2019,(SW) APSN Centre for Adults,170,146,7,24
31/3/2019,(SW) BizLink Sheltered Workshop,136,150,15,-14
31/3/2019,(SW) Cerebral Palsy Alliance Singapore GROW,100,87,3,13
31/3/2019,(SW) MINDS IDEA Employment Development Centre,300,300,3,0
31/3/2019,(SW) SIA-MINDS Employment Development Centre,350,380,5,-30
31/3/2019,(SW) MINDS Woodlands Employment Development Centre,400,359,5,41
31/3/2019,(SW) SPD Sheltered Workshop,145,145,6,0
31/3/2019,(SW) THK-Pan-Disability Centre,100,73,9,27
30/4/2019,(SW) APSN Centre for Adults,170,148,10,22
30/4/2019,(SW) BizLink Sheltered Workshop,136,150,15,-14
30/4/2019,(SW) Cerebral Palsy Alliance Singapore GROW,100,86,2,14
30/4/2019,(SW) MINDS IDEA Employment Development Centre,300,300,4,0
30/4/2019,(SW) SIA-MINDS Employment Development Centre,350,380,4,-30
30/4/2019,(SW) MINDS Woodlands Employment Development Centre,400,354,6,46
30/4/2019,(SW) SPD Sheltered Workshop,145,145,4,0
30/4/2019,(SW) THK-Pan-Disability Centre,100,72,13,28
31/5/2019,(SW) APSN Centre for Adults,170,154,13,16
31/5/2019,(SW) BizLink Sheltered Workshop,136,150,12,-14
31/5/2019,(SW) Cerebral Palsy Alliance Singapore GROW,100,85,2,15
31/5/2019,(SW) MINDS IDEA Employment Development Centre,300,299,4,1
31/5/2019,(SW) SIA-MINDS Employment Development Centre,350,376,4,-26
31/5/2019,(SW) MINDS Woodlands Employment Development Centre,400,352,5,48
31/5/2019,(SW) SPD Sheltered Workshop,145,144,4,1
31/5/2019,(SW) THK-Pan-Disability Centre,100,72,16,28
30/6/2019,(SW) APSN Centre for Adults,170,156,10,14
30/6/2019,(SW) BizLink Sheltered Workshop,136,150,12,-14
30/6/2019,(SW) Cerebral Palsy Alliance Singapore GROW,100,84,2,16
30/6/2019,(SW) MINDS IDEA Employment Development Centre,300,300,1,0
30/6/2019,(SW) SIA-MINDS Employment Development Centre,350,378,2,-28
30/6/2019,(SW) MINDS Woodlands Employment Development Centre,400,354,5,46
30/6/2019,(SW) SPD Sheltered Workshop,145,143,4,2
31/7/2019,(SW) Cerebral Palsy Alliance Singapore GROW,100,84,1,16
31/7/2019,(SW) MINDS IDEA Employment Development Centre,300,300,2,0
31/7/2019,(SW) MINDS Woodlands Employment Development Centre,400,353,7,47
31/7/2019,(SW) THK-Pan-Disability Centre,100,79,13,21
31/8/2019,(SW) APSN Centre for Adults,170,162,14,8
31/8/2019,(SW) THK-Pan-Disability Centre,100,79,13,21
30/9/2019,(SW) APSN Centre for Adults,170,161,11,9
30/9/2019,(SW) MINDS IDEA Employment Development Centre,300,302,6,-2
30/9/2019,(SW) MINDS Woodlands Employment Development Centre,400,350,22,50
30/9/2019,(SW) SPD Sheltered Workshop,145,146,8,-1
31/1/2020,(SW) Cerebral Palsy Alliance Singapore GROW,100,87,7,13
31/1/2020,(SW) MINDS IDEA Employment Development Centre,300,304,5,-4
31/1/2020,(SW) SIA-MINDS Employment Development Centre,350,382,5,-32
31/1/2020,(SW) SPD Sheltered Workshop,145,133,6,12
31/10/2020,(SW) APSN Centre for Adults,170,149,30,21
31/10/2020,(SW) BizLink Sheltered Workshop,136,149,15,-13
31/10/2020,(SW) Cerebral Palsy Alliance Singapore GROW,100,88,16,12
31/10/2020,(SW) SIA-MINDS Employment Development Centre,350,380,20,-30
31/10/2020,(SW) THK-Pan-Disability Centre,100,77,8,23
30/11/2020,(SW) BizLink Sheltered Workshop,136,149,18,-13
30/11/2020,(SW) THK-Pan-Disability Centre,100,76,9,24
30/11/2020,(SW) MINDS IDEA Employment Development Centre,300,298,21,2
30/11/2020,(SW) SPD Sheltered Workshop,145,127,17,18
31/12/2020,(SW) APSN Centre for Adults,170,148,36,22
31/12/2020,(SW) SIA-MINDS Employment Development Centre,350,374,20,-24
31/12/2020,(SW) THK-Pan-Disability Centre,100,73,12,27
29/2/2020,(SW) BizLink Sheltered Workshop,136,157,12,-21
29/2/2020,(SW) SIA-MINDS Employment Development Centre,350,380,6,-30
29/2/2020,(SW) MINDS Woodlands Employment Development Centre,400,371,11,29
29/2/2020,(SW) THK-Pan-Disability Centre,100,82,12,18
31/3/2020,(SW) THK-Pan-Disability Centre,100,83,11,17
30/4/2020,(SW) APSN Centre for Adults,170,160,10,10
30/4/2020,(SW) BizLink Sheltered Workshop,136,156,11,-20
30/4/2020,(SW) THK-Pan-Disability Centre,100,84,9,16
31/5/2020,(SW) APSN Centre for Adults,170,159,10,11
31/5/2020,(SW) BizLink Sheltered Workshop,136,151,11,-15
31/5/2020,(SW) MINDS IDEA Employment Development Centre,300,304,2,-4
31/5/2020,(SW) SIA-MINDS Employment Development Centre,350,382,4,-32
31/5/2020,(SW) MINDS Woodlands Employment Development Centre,400,370,10,30
31/5/2020,(SW) SPD Sheltered Workshop,145,135,4,10
31/5/2020,(SW) THK-Pan-Disability Centre,100,83,10,17
30/6/2020,(SW) APSN Centre for Adults,170,159,15,11
30/6/2020,(SW) BizLink Sheltered Workshop,136,150,11,-14
30/6/2020,(SW) Cerebral Palsy Alliance Singapore GROW,100,89,3,11
30/6/2020,(SW) THK-Pan-Disability Centre,100,82,9,18
31/7/2020,(SW) APSN Centre for Adults,170,153,33,17
31/7/2020,(SW) BizLink Sheltered Workshop,136,149,11,-13
31/7/2020,(SW) Cerebral Palsy Alliance Singapore GROW,100,89,11,11
31/7/2020,(SW) MINDS IDEA Employment Development Centre,300,304,11,-4
31/7/2020,(SW) SIA-MINDS Employment Development Centre,350,382,13,-32
31/7/2020,(SW) THK-Pan-Disability Centre,100,81,17,19
31/8/2020,(SW) Cerebral Palsy Alliance Singapore GROW,100,89,16,11
31/8/2020,(SW) MINDS IDEA Employment Development Centre,300,304,18,-4
31/8/2020,(SW) SIA-MINDS Employment Development Centre,350,382,23,-32
31/8/2020,(SW) MINDS Woodlands Employment Development Centre,400,369,33,31
30/9/2020,(SW) APSN Centre for Adults,170,149,32,21
30/9/2020,(SW) Cerebral Palsy Alliance Singapore GROW,100,88,16,12
30/9/2020,(SW) THK-Pan-Disability Centre,100,76,10,24
31/1/2021,(SW) SIA-MINDS Employment Development Centre,350,388,6,-38
31/1/2021,(SW) MINDS Woodlands Employment Development Centre,400,391,16,9
31/1/2021,(SW) THK-Pan-Disability Centre,100,79,15,21
31/10/2021,(SW) APSN Centre for Adults,170,169,18,1
31/10/2021,(SW) BizLink Sheltered Workshop,136,145,19,-9
31/10/2021,(SW) SIA-MINDS Employment Development Centre,350,388,13,-38
31/10/2021,(SW) SPD Sheltered Workshop,145,127,5,18
30/11/2021,(SW) MINDS IDEA Employment Development Centre,300,312,14,-12
30/11/2021,(SW) MINDS Woodlands Employment Development Centre,400,390,21,10
30/11/2021,(SW) SPD Sheltered Workshop,145,127,6,18
30/11/2021,(SW) THK-Pan-Disability Centre,100,85,17,15
31/12/2021,(SW) APSN Centre for Adults,170,165,20,5
31/12/2021,(SW) BizLink Sheltered Workshop,136,149,22,-13
31/12/2021,(SW) SIA-MINDS Employment Development Centre,350,379,11,-29
31/12/2021,(SW) MINDS Woodlands Employment Development Centre,400,386,20,14
31/12/2021,(SW) SPD Sheltered Workshop,145,127,11,18
28/2/2021,(SW) APSN Centre for Adults,170,161,35,9
28/2/2021,(SW) BizLink Sheltered Workshop,136,143,23,-7
28/2/2021,(SW) MINDS IDEA Employment Development Centre,300,312,4,-12
28/2/2021,(SW) SIA-MINDS Employment Development Centre,350,387,8,-37
28/2/2021,(SW) MINDS Woodlands Employment Development Centre,400,392,16,8
28/2/2021,(SW) SPD Sheltered Workshop,145,128,17,17
28/2/2021,(SW) THK-Pan-Disability Centre,100,82,9,18
31/3/2021,(SW) APSN Centre for Adults,170,167,40,3
31/3/2021,(SW) BizLink Sheltered Workshop,136,144,18,-8
31/3/2021,(SW) Cerebral Palsy Alliance Singapore GROW,100,94,1,6
30/4/2021,(SW) APSN Centre for Adults,170,170,19,0
30/4/2021,(SW) BizLink Sheltered Workshop,136,143,18,-7
30/4/2021,(SW) SPD Sheltered Workshop,145,129,16,16
31/5/2021,(SW) APSN Centre for Adults,170,173,16,-3
30/6/2021,(SW) APSN Centre for Adults,170,172,16,-2
30/6/2021,(SW) BizLink Sheltered Workshop,136,145,21,-9
30/6/2021,(SW) Cerebral Palsy Alliance Singapore GROW,100,92,1,8
30/6/2021,(SW) SPD Sheltered Workshop,145,127,13,18
31/7/2021,(SW) APSN Centre for Adults,170,171,15,-1
31/7/2021,(SW) Cerebral Palsy Alliance Singapore GROW,100,92,1,8
31/7/2021,(SW) MINDS Woodlands Employment Development Centre,400,393,18,7
31/8/2021,(SW) BizLink Sheltered Workshop,136,149,13,-13
31/8/2021,(SW) Cerebral Palsy Alliance Singapore GROW,100,92,1,8
31/8/2021,(SW) MINDS IDEA Employment Development Centre,300,311,6,-11
31/8/2021,(SW) SIA-MINDS Employment Development Centre,350,392,5,-42
31/8/2021,(SW) THK-Pan-Disability Centre,100,85,5,15
30/9/2021,(SW) APSN Centre for Adults,170,169,13,1
30/9/2021,(SW) BizLink Sheltered Workshop,136,146,12,-10
30/9/2021,(SW) MINDS IDEA Employment Development Centre,300,311,4,-11
30/9/2021,(SW) MINDS Woodlands Employment Development Centre,400,390,19,10
31/1/2022,(SW) APSN Centre for Adults,170,165,6,5
31/1/2022,(SW) Cerebral Palsy Alliance Singapore GROW,100,90,8,10
31/1/2022,(SW) SPD Sheltered Workshop,145,127,10,18
31/1/2022,(SW) THK-Pan-Disability Centre,100,88,18,12
31/10/2018,(Hostel) Touch Ubi Hostel,30,30,5,0
31/10/2018,(ADH) Bishan Home for the Intellectually Disabled,132,121,5,11
31/10/2018,(ADH) Blue Cross Thong Kheng Home,116,98,7,18
31/10/2018,(ADH) THK Home for the Disabled @ Chai Chee,102,97,6,5
31/10/2018,(CGH) MINDSVille @ Napiri,10,8,3,2
31/10/2018,(Hostel) MINDSVille @ Napiri,60,48,15,12
30/11/2018,(ADH) Bishan Home for the Intellectually Disabled,132,121,5,11
30/11/2018,(ADH) Blue Cross Thong Kheng Home,116,97,5,19
30/11/2018,(ADH) Red Cross Home for the Disabled,100,89,11,11
30/11/2018,(CGH) MINDSVille @ Napiri,10,8,3,2
30/11/2018,(Hostel) MINDSVille @ Napiri,60,50,14,10
30/11/2018,(Hostel) Touch Ubi Hostel,30,30,4,0
31/12/2018,(ADH) THK Home for Disabled @ Sembawang,180,56,40,124
31/12/2018,(Hostel) Touch Ubi Hostel,30,30,5,0
31/12/2018,(ADH) Bishan Home for the Intellectually Disabled,132,122,4,10
31/12/2018,(ADH) Blue Cross Thong Kheng Home,116,96,4,20
31/12/2018,(ADH) Metta Home for the Disabled,98,89,8,9
31/12/2018,(ADH) MINDSVille @ Napiri,160,121,24,39
31/12/2018,(ADH) THK Home for the Disabled @ Eunos,88,84,10,4
31/3/2018,(Hostel) THK Home for the Disabled @ Eunos,40,39,19,1
30/4/2018,(ADH) Blue Cross Thong Kheng Home,116,105,13,11
30/4/2018,(ADH) Red Cross Home for the Disabled,100,92,6,8
30/4/2018,(ADH) Metta Home for the Disabled,103,91,8,12
30/4/2018,(CGH) MINDSVille @ Napiri,10,8,2,2
30/4/2018,(Hostel) MINDSVille @ Napiri,60,48,7,12
30/4/2018,(Hostel) Touch Ubi Hostel,30,30,3,0
31/5/2018,(ADH) Red Cross Home for the Disabled,100,93,14,7
31/5/2018,(ADH) THK Home for Disabled @ Sembawang,180,23,91,157
31/5/2018,(ADH) Bishan Home for the Intellectually Disabled,132,125,1,7
31/5/2018,(CGH) MINDSVille @ Napiri,10,8,4,2
30/6/2018,(CGH) MINDSVille @ Napiri,10,8,4,2
30/6/2018,(ADH) MINDSVille @ Napiri,160,126,26,34
30/6/2018,(ADH) Singapore Cheshire Home,90,77,4,13
30/6/2018,(ADH) THK Home for the Disabled @ Eunos,88,83,22,5
30/6/2018,(Hostel) THK Home for the Disabled @ Eunos,40,38,28,2
30/6/2018,(Hostel) Touch Ubi Hostel,30,30,4,0
30/6/2018,(ADH) Metta Home for the Disabled,103,90,6,13
30/6/2018,(ADH) THK Home for the Disabled @ Chai Chee,102,98,0,4
30/6/2018,(ADH) THK Home for Disabled @ Sembawang,180,30,76,150
31/7/2018,(ADH) MINDSVille @ Napiri,160,131,27,29
31/7/2018,(ADH) THK Home for Disabled @ Sembawang,180,40,62,140
31/7/2018,(Hostel) THK Home for the Disabled @ Eunos,40,38,29,2
31/7/2018,(ADH) Metta Home for the Disabled,103,90,7,13
31/7/2018,(CGH) MINDSVille @ Napiri,10,8,4,2
31/7/2018,(Hostel) Touch Ubi Hostel,30,30,4,0
31/8/2018,(ADH) MINDSVille @ Napiri,160,129,29,31
31/8/2018,(ADH) Red Cross Home for the Disabled,100,90,7,10
30/8/2018,(ADH) THK Home for the Disabled @ Eunos,88,82,20,6
31/8/2018,(ADH) Blue Cross Thong Kheng Home,116,105,10,11
30/8/2018,(ADH) THK Home for the Disabled @ Chai Chee,102,97,3,5
31/8/2018,(Hostel) MINDSVille @ Napiri,60,49,12,11
30/9/2018,(ADH) THK Home for the Disabled @ Eunos,88,82,17,6
30/9/2018,(Hostel) THK Home for the Disabled @ Eunos,40,38,21,2
30/9/2018,(Hostel) Touch Ubi Hostel,30,30,5,0
30/9/2018,(ADH) Blue Cross Thong Kheng Home,116,102,10,14
30/9/2018,(ADH) Red Cross Home for the Disabled,100,90,6,10
30/9/2018,(ADH) THK Home for the Disabled @ Chai Chee,102,97,5,5
30/9/2018,(CGH) MINDSVille @ Napiri,10,8,3,2
30/9/2018,(Hostel) MINDSVille @ Napiri,60,49,15,11
31/1/2019,(ADH) THK Home for the Disabled @ Chai Chee,102,99,6,3
31/1/2019,(Hostel) Touch Ubi Hostel,30,30,5,0
31/1/2019,(ADH) Bishan Home for the Intellectually Disabled,132,122,3,10
31/1/2019,(ADH) Blue Cross Thong Kheng Home,116,96,5,20
31/1/2019,(ADH) Metta Home for the Disabled,103,88,7,15
31/1/2019,(ADH) Singapore Cheshire Home,90,72,2,18
31/1/2019,(CGH) MINDSVille @ Napiri,10,8,5,2
31/1/2019,(Hostel) MINDSVille @ Napiri,60,50,15,10
31/1/2019,(Hostel) THK Home for the Disabled @ Eunos,40,38,22,2
28/2/2019,(ADH) THK Home for the Disabled @ Chai Chee,102,99,9,3
28/2/2019,(ADH) THK Home for Disabled @ Sembawang,184,57,47,127
28/2/2019,(Hostel) Touch Ubi Hostel,30,30,5,0
28/2/2019,(ADH) Bishan Home for the Intellectually Disabled,132,121,3,11
28/2/2019,(ADH) Blue Cross Thong Kheng Home,116,95,7,21
28/2/2019,(ADH) Red Cross Home for the Disabled,100,91,9,9
28/2/2019,(ADH) Singapore Cheshire Home,90,71,2,19
28/2/2019,(ADH) THK Home for the Disabled @ Eunos,88,82,12,6
28/2/2019,(CGH) MINDSVille @ Napiri,10,8,5,2
31/3/2019,(ADH) THK Home for Disabled @ Sembawang,184,69,45,115
31/3/2019,(ADH) Blue Cross Thong Kheng Home,116,95,9,21
31/3/2019,(ADH) Metta Home for the Disabled,103,89,4,14
31/3/2019,(ADH) MINDSVille @ Napiri,160,125,25,35
31/3/2019,(ADH) Red Cross Home for the Disabled,100,91,7,9
30/4/2019,(ADH) THK Home for the Disabled @ Chai Chee,102,98,14,4
30/4/2019,(ADH) THK Home for Disabled @ Sembawang,180,69,45,111
30/4/2019,(Hostel) Touch Ubi Hostel,30,31,4,-1
30/4/2019,(ADH) Blue Cross Thong Kheng Home,116,96,9,20
30/4/2019,(ADH) St Andrew's Adult Home (Sengkang),200,2,19,198
30/4/2019,(ADH) THK Home for the Disabled @ Eunos,88,81,10,7
31/5/2019,(ADH) THK Home for Disabled @ Sembawang,180,69,46,111
31/5/2019,(ADH) Bishan Home for the Intellectually Disabled,132,127,1,5
31/5/2019,(ADH) Blue Cross Thong Kheng Home,116,98,6,18
31/5/2019,(ADH) Red Cross Home for the Disabled,100,91,8,9
31/5/2019,(Hostel) MINDSVille @ Napiri,60,50,16,10
31/5/2019,(Hostel) THK Home for the Disabled @ Eunos,40,42,22,-2
30/6/2019,(ADH) MINDSVille @ Napiri,160,125,28,35
30/6/2019,(CGH) MINDSVille @ Napiri,10,8,6,2
31/10/2019,(ADH) THK Home for Disabled @ Sembawang,180,86,27,94
31/10/2019,(ADH) Bishan Home for the Intellectually Disabled,132,126,1,6
31/10/2019,(ADH) MINDSVille @ Napiri,160,122,35,38
31/10/2019,(ADH) Red Cross Home for the Disabled,100,93,12,7
31/10/2019,(ADH) St Andrew's Adult Home (Sengkang),148,12,15,136
31/10/2019,(ADH) THK Home for the Disabled @ Eunos,88,82,10,6
31/10/2019,(Hostel) THK Home for the Disabled @ Eunos,40,43,22,-3
31/10/2019,(Hostel) Touch Ubi Hostel,30,29,6,1
31/10/2019,(DAC) Metta Home @ Hougang,40,32,3,8
31/10/2019,(DAC) Blue Cross Thong Kheng ASD Day Activity Centre,60,28,19,32
31/10/2019,(DAC) Emmanuel Activity Centre @ Toa Payoh,83,53,12,30
31/10/2019,(DAC) Cerebral Palsy Alliance Singapore,70,61,12,9
31/10/2019,(DAC) MINDS Training & Development Centre @ Ang Mo Kio,55,51,2,4
31/10/2019,(DAC) MINDS Training & Development Centre @ Napiri,50,59,12,-9
31/10/2019,(DAC) MINDS Training & Development Centre @ Tampines,47,53,5,-6
31/10/2019,(DAC) Singapore Cheshire Home,50,26,3,24
31/10/2019,(DAC) SPD Day Activity Centre,91,85,4,6
31/10/2019,(DAC) St Andrew's Autism Centre (Sengkang),50,25,14,25
31/10/2019,(DAC) St Andrew's Autism Centre (Siglap),97,67,10,30
31/10/2019,(DAC) SUN-DAC @ Bedok,50,44,3,6
31/10/2019,(DAC) SUN-DAC @ Choa Chu Kang,50,49,0,1
31/10/2019,(DAC) SUN-DAC @ Upper Thomson,120,35,10,85
31/10/2019,(DAC) TOUCH Centre for Independent Living - Bukit Merah,42,22,2,20
31/10/2019,(DAC) TOUCH Centre for Independent Living - Ubi,50,38,0,12
31/10/2019,(SW) BizLink Sheltered Workshop,136,150,17,-14
31/10/2019,(SW) Cerebral Palsy Alliance Singapore GROW,100,83,14,17
31/10/2019,(SW) MINDS Woodlands Employment Development Centre,400,355,28,45
31/10/2019,(SW) THK-Pan-Disability Centre,100,83,10,17
30/11/2019,(ADH) Blue Cross Thong Kheng Home,116,96,12,20
30/11/2019,(ADH) Metta Home for the Disabled,103,87,4,16
30/11/2019,(ADH) Singapore Cheshire Home,90,73,3,17
30/11/2019,(CGH) MINDSVille @ Napiri,10,8,7,2
30/11/2019,(Hostel) MINDSVille @ Napiri,60,51,16,9
30/11/2019,(DAC) THK Day Activity Centre @ Chai Chee,50,19,4,31
30/11/2019,(DAC) THK Autism Centre @ Geylang Bahru,66,23,9,43
30/11/2019,(DAC) Blue Cross Thong Kheng ASD Day Activity Centre,60,28,18,32
30/11/2019,(DAC) Emmanuel Activity Centre @ Tampines,50,50,3,0
30/11/2019,(DAC) Emmanuel Activity Centre @ Toa Payoh,83,53,12,30
30/11/2019,(DAC) Eden Centre for Adults @ Clementi,40,43,10,-3
30/11/2019,(DAC) Metta Home @ Hougang,40,32,2,8
30/11/2019,(DAC) MINDS Training & Development Centre @ Ang Mo Kio,55,50,3,5
30/11/2019,(DAC) MINDS Training & Development Centre @ Faber,41,37,0,4
30/11/2019,(DAC) MINDS Training & Development Centre @ Tampines,47,52,3,-5
30/11/2019,(DAC) MINDS Training & Development Centre @ Yishun,61,53,7,8
30/11/2019,(DAC) Red Cross Day Activity Centre,50,11,5,39
30/11/2019,(DAC) SPD Day Activity Centre,91,85,5,6
30/11/2019,(DAC) St Andrew's Autism Centre (Sengkang),50,28,9,22
30/11/2019,(DAC) SUN-DAC @ Choa Chu Kang,50,49,0,1
30/11/2019,(SW) APSN Centre for Adults,170,163,13,7
30/11/2019,(SW) BizLink Sheltered Workshop,136,150,18,-14
30/11/2019,(SW) Cerebral Palsy Alliance Singapore GROW,100,83,13,17
30/11/2019,(SW) MINDS IDEA Employment Development Centre,300,296,12,4
30/11/2019,(SW) MINDS Woodlands Employment Development Centre,400,357,26,43
31/12/2019,(ADH) THK Home for the Disabled @ Chai Chee,102,99,8,3
31/12/2019,(ADH) THK Home for the Disabled @ Eunos,88,81,10,7
31/12/2019,(ADH) THK Home for Disabled @ Sembawang,180,86,34,94
31/12/2019,(Hostel) THK Home for the Disabled @ Eunos,40,42,23,-2
31/12/2019,(ADH) Bishan Home for the Intellectually Disabled,132,126,0,6
31/12/2019,(ADH) Blue Cross Thong Kheng Home,116,92,13,24
31/12/2019,(ADH) Metta Home for the Disabled,103,87,3,16
31/12/2019,(ADH) MINDSVille @ Napiri,160,119,31,41
31/12/2019,(ADH) Red Cross Home for the Disabled,100,92,15,8
31/12/2019,(ADH) St Andrew's Adult Home (Sengkang),148,14,17,134
31/12/2019,(CGH) MINDSVille @ Napiri,10,8,7,2
31/12/2019,(Hostel) MINDSVille @ Napiri,60,48,18,12
31/12/2019,(DAC) THK Day Activity Centre @ Chai Chee,50,19,4,31
31/12/2019,(DAC) BizLink Day Activity Centre,40,35,6,5
31/12/2019,(DAC) Blue Cross Thong Kheng ASD Day Activity Centre,60,28,20,32
31/12/2019,(DAC) Blue Cross Thong Kheng Home,50,32,4,18
31/12/2019,(DAC) Eden Centre for Adults @ Clementi,40,43,10,-3
31/12/2019,(DAC) Eden Centre for Adults @ Hougang,40,42,6,-2
31/12/2019,(DAC) Metta Home @ Hougang,40,32,2,8
31/12/2019,(DAC) MINDS Training & Development Centre @ Jurong,53,43,2,10
31/12/2019,(DAC) MINDS Training & Development Centre @ Napiri,50,58,11,-8
31/12/2019,(DAC) MINDS Training & Development Centre @ Tampines,47,52,4,-5
31/12/2019,(DAC) MINDS Training & Development Centre @ Yishun,61,53,7,8
31/12/2019,(DAC) SPD Day Activity Centre,91,84,5,7
31/12/2019,(DAC) St Andrew's Autism Centre (Siglap),97,67,10,30
31/12/2019,(DAC) SUN-DAC @ Bedok,50,46,0,4
31/12/2019,(DAC) TOUCH Centre for Independent Living - Ubi,50,37,0,13
31/12/2019,(SW) BizLink Sheltered Workshop,136,153,17,-17
31/12/2019,(SW) Cerebral Palsy Alliance Singapore GROW,100,85,10,15
31/12/2019,(SW) MINDS IDEA Employment Development Centre,300,295,12,5
31/12/2019,(SW) MINDS Woodlands Employment Development Centre,400,357,27,43
31/12/2019,(SW) SPD Sheltered Workshop,145,134,8,11
31/12/2019,(SW) THK-Pan-Disability Centre,100,81,12,19
30/6/2019,(ADH) THK Home for Disabled @ Sembawang,180,71,51,109
30/6/2019,(ADH) Blue Cross Thong Kheng Home,116,97,7,19
30/6/2019,(ADH) Red Cross Home for the Disabled,100,91,10,9
30/6/2019,(Hostel) MINDSVille @ Napiri,60,51,16,9
30/6/2019,(DAC) Metta Home @ Hougang,40,32,3,8
30/6/2019,(DAC) THK Day Activity Centre @ Chai Chee,50,17,4,33
30/6/2019,(DAC) Bishan Home for the Intellectually Disabled,50,24,1,26
30/6/2019,(DAC) Blue Cross Thong Kheng Home,50,31,3,19
30/6/2019,(DAC) Emmanuel Activity Centre @ Tampines,50,55,2,-5
30/6/2019,(DAC) Emmanuel Activity Centre @ Toa Payoh,83,50,14,33
30/6/2019,(DAC) Cerebral Palsy Alliance Singapore,50,50,20,0
30/6/2019,(DAC) Eden Centre for Adults @ Clementi,40,44,9,-4
30/6/2019,(DAC) Metta Home @ Woodlands,50,28,1,22
30/6/2019,(DAC) MINDS Training & Development Centre @ Ang Mo Kio,55,51,1,4
30/6/2019,(DAC) MINDS Training & Development Centre @ Eunos,100,69,1,31
30/6/2019,(DAC) MINDS Training & Development Centre @ Faber,41,39,1,2
30/6/2019,(DAC) MINDS Training & Development Centre @ Jurong,53,47,0,6
30/6/2019,(DAC) MINDS Training & Development Centre @ Yishun,61,53,0,8
30/6/2019,(DAC) Red Cross Day Activity Centre,50,9,2,41
30/6/2019,(DAC) Singapore Cheshire Home,50,25,1,25
30/6/2019,(DAC) SPD Day Activity Centre,91,86,8,5
30/6/2019,(DAC) SUN-DAC @ Upper Thomson,120,33,6,87
30/6/2019,(SW) THK-Pan-Disability Centre,100,79,11,21
31/7/2019,(ADH) THK Home for Disabled @ Sembawang,180,72,29,108
31/7/2019,(ADH) Blue Cross Thong Kheng Home,116,98,7,18
31/7/2019,(ADH) MINDSVille @ Napiri,160,124,26,36
31/7/2019,(ADH) Singapore Cheshire Home,90,70,7,20
31/7/2019,(ADH) THK Home for the Disabled @ Eunos,88,82,10,6
31/7/2019,(CGH) MINDSVille @ Napiri,10,8,7,2
31/7/2019,(DAC) BizLink Day Activity Centre,40,35,4,5
31/7/2019,(DAC) Emmanuel Activity Centre @ Tampines,50,55,2,-5
31/7/2019,(DAC) Emmanuel Activity Centre @ Toa Payoh,83,50,14,33
31/7/2019,(DAC) THK Day Activity Centre @ Chai Chee,50,17,5,33
31/7/2019,(DAC) THK Autism Centre @ Geylang Bahru,66,25,3,41
31/7/2019,(DAC) Blue Cross Thong Kheng ASD Day Activity Centre,60,22,11,38
31/7/2019,(DAC) Cerebral Palsy Alliance Singapore,50,50,20,0
31/7/2019,(DAC) Eden Centre for Adults @ Hougang,40,42,2,-2
31/7/2019,(DAC) MINDS Training & Development Centre @ Faber,41,39,1,2
31/7/2019,(DAC) MINDS Training & Development Centre @ Jurong,53,45,0,8
31/7/2019,(DAC) MINDS Training & Development Centre @ Napiri,50,58,10,-8
31/7/2019,(DAC) Red Cross Day Activity Centre,50,9,2,41
31/7/2019,(DAC) Singapore Cheshire Home,50,25,2,25
31/7/2019,(DAC) St Andrew's Autism Centre (Siglap),97,65,8,32
31/7/2019,(DAC) SUN-DAC @ Choa Chu Kang,50,49,1,1
31/7/2019,(DAC) TOUCH Centre for Independent Living - Bukit Merah,42,22,0,20
31/7/2019,(DAC) TOUCH Centre for Independent Living - Ubi,50,38,0,12
31/7/2019,(SW) APSN Centre for Adults,170,154,16,16
31/7/2019,(SW) BizLink Sheltered Workshop,136,151,11,-15
31/7/2019,(SW) SIA-MINDS Employment Development Centre,350,376,3,-26
31/7/2019,(SW) SPD Sheltered Workshop,145,148,5,-3
31/8/2019,(ADH) THK Home for the Disabled @ Chai Chee,102,99,10,3
31/8/2019,(ADH) THK Home for Disabled @ Sembawang,180,74,38,106
31/8/2019,(ADH) Red Cross Home for the Disabled,100,93,8,7
31/8/2019,(ADH) Singapore Cheshire Home,90,71,4,19
31/8/2019,(CGH) MINDSVille @ Napiri,10,8,7,2
31/8/2019,(DAC) Bishan Home for the Intellectually Disabled,50,24,1,26
31/8/2019,(DAC) Blue Cross Thong Kheng ASD Day Activity Centre,60,26,13,34
31/8/2019,(DAC) Blue Cross Thong Kheng Home,50,32,4,18
31/8/2019,(DAC) Cerebral Palsy Alliance Singapore,70,61,10,9
31/8/2019,(DAC) Eden Centre for Adults @ Hougang,40,43,2,-3
31/8/2019,(DAC) MINDS Training & Development Centre @ Clementi,55,48,0,7
31/8/2019,(DAC) MINDS Training & Development Centre @ Eunos,100,69,7,31
31/8/2019,(DAC) MINDS Training & Development Centre @ Faber,41,40,0,1
31/8/2019,(DAC) MINDS Training & Development Centre @ Napiri,50,58,11,-8
31/8/2019,(DAC) Red Cross Day Activity Centre,50,10,3,40
31/8/2019,(DAC) Singapore Cheshire Home,50,25,3,25
31/8/2019,(DAC) SPD Day Activity Centre,91,86,4,5
31/8/2019,(DAC) St Andrew's Autism Centre (Sengkang),50,25,14,25
31/8/2019,(DAC) St Andrew's Autism Centre (Siglap),97,65,8,32
31/8/2019,(DAC) SUN-DAC @ Bedok,50,42,4,8
31/8/2019,(DAC) SUN-DAC @ Choa Chu Kang,50,50,1,0
31/8/2019,(DAC) SUN-DAC @ Upper Thomson,120,33,8,87
31/8/2019,(DAC) THK Day Activity Centre @ Chai Chee,50,18,3,32
31/8/2019,(DAC) THK Autism Centre @ Geylang Bahru,66,23,6,43
31/8/2019,(DAC) TOUCH Centre for Independent Living - Ubi,50,38,0,12
31/8/2019,(SW) BizLink Sheltered Workshop,136,156,11,-20
31/8/2019,(SW) Cerebral Palsy Alliance Singapore GROW,100,84,8,16
31/8/2019,(SW) MINDS IDEA Employment Development Centre,300,302,6,-2
31/8/2019,(SW) SIA-MINDS Employment Development Centre,350,374,9,-24
31/8/2019,(SW) MINDS Woodlands Employment Development Centre,400,352,11,48
31/8/2019,(SW) SPD Sheltered Workshop,145,148,6,-3
30/9/2019,(ADH) St Andrew's Adult Home (Sengkang),148,11,11,137
30/9/2019,(ADH) THK Home for the Disabled @ Eunos,88,83,10,5
30/9/2019,(CGH) MINDSVille @ Napiri,10,8,7,2
30/9/2019,(Hostel) THK Home for the Disabled @ Eunos,40,43,22,-3
30/9/2019,(Hostel) Touch Ubi Hostel,30,31,5,-1
30/9/2019,(DAC) Blue Cross Thong Kheng ASD Day Activity Centre,60,25,18,35
30/9/2019,(DAC) Blue Cross Thong Kheng Home,50,32,4,18
30/9/2019,(DAC) Cerebral Palsy Alliance Singapore,70,61,12,9
30/9/2019,(DAC) Eden Centre for Adults @ Clementi,40,45,11,-5
30/9/2019,(DAC) Eden Centre for Adults @ Hougang,40,43,4,-3
30/9/2019,(DAC) MINDS Training & Development Centre @ Ang Mo Kio,55,51,2,4
30/9/2019,(DAC) MINDS Training & Development Centre @ Faber,41,39,0,2
30/9/2019,(DAC) MINDS Training & Development Centre @ Jurong,53,44,2,9
30/9/2019,(DAC) MINDS Training & Development Centre @ Tampines,47,53,6,-6
30/9/2019,(DAC) MINDS Training & Development Centre @ Yishun,61,52,7,9
30/9/2019,(DAC) Singapore Cheshire Home,50,27,3,23
30/9/2019,(DAC) St Andrew's Autism Centre (Siglap),97,65,11,32
30/9/2019,(DAC) SUN-DAC @ Choa Chu Kang,50,50,0,0
30/9/2019,(DAC) SUN-DAC @ Upper Thomson,120,35,9,85
30/9/2019,(DAC) TOUCH Centre for Independent Living - Bukit Merah,42,22,1,20
30/9/2019,(SW) BizLink Sheltered Workshop,136,150,14,-14
30/9/2019,(SW) Cerebral Palsy Alliance Singapore GROW,100,84,9,16
30/9/2019,(SW) SIA-MINDS Employment Development Centre,350,373,17,-23
30/9/2019,(SW) THK-Pan-Disability Centre,100,82,12,18
31/1/2020,(ADH) THK Home for the Disabled @ Eunos,88,81,12,7
31/1/2020,(Hostel) THK Home for the Disabled @ Eunos,40,42,23,-2
31/1/2020,(ADH) Blue Cross Thong Kheng Home,116,93,13,23
31/1/2020,(ADH) Metta Home for the Disabled,103,86,3,17
31/1/2020,(ADH) MINDSVille @ Napiri,160,117,34,43
31/1/2020,(ADH) Red Cross Home for the Disabled,100,94,7,6
31/1/2020,(ADH) St Andrew's Adult Home (Sengkang),148,14,18,134
31/1/2020,(CGH) MINDSVille @ Napiri,10,8,7,2
31/1/2020,(Hostel) MINDSVille @ Napiri,60,46,26,14
31/1/2020,(DAC) THK Day Activity Centre @ Chai Chee,50,18,3,32
31/1/2020,(DAC) Blue Cross Thong Kheng Home,50,32,4,18
31/1/2020,(DAC) Emmanuel Activity Centre @ Toa Payoh,83,57,12,26
31/1/2020,(DAC) Cerebral Palsy Alliance Singapore,70,68,2,2
31/1/2020,(DAC) Eden Centre for Adults @ Hougang,40,42,5,-2
31/1/2020,(DAC) Metta Home @ Hougang,40,32,2,8
31/1/2020,(DAC) Metta Home @ Woodlands,50,28,3,22
31/1/2020,(DAC) MINDS Training & Development Centre @ Clementi,55,49,2,6
31/1/2020,(DAC) MINDS Training & Development Centre @ Eunos,100,70,2,30
31/1/2020,(DAC) MINDS Training & Development Centre @ Faber,41,37,0,4
31/1/2020,(DAC) MINDS Training & Development Centre @ Napiri,50,59,10,-9
31/1/2020,(DAC) MINDS Training & Development Centre @ Tampines,47,52,3,-5
31/1/2020,(DAC) Red Cross Day Activity Centre,50,11,3,39
31/1/2020,(DAC) SPD Day Activity Centre,91,86,2,5
31/1/2020,(DAC) St Andrew's Autism Centre (Siglap),97,69,8,28
31/1/2020,(DAC) SUN-DAC @ Bedok,50,46,0,4
31/1/2020,(DAC) SUN-DAC @ Choa Chu Kang,50,48,4,2
31/1/2020,(DAC) TOUCH Centre for Independent Living - Bukit Merah,42,23,1,19
31/1/2020,(SW) APSN Centre for Adults,170,164,11,6
31/1/2020,(SW) BizLink Sheltered Workshop,136,154,12,-18
31/1/2020,(SW) MINDS Woodlands Employment Development Centre,400,370,11,30
31/1/2020,(SW) THK-Pan-Disability Centre,100,81,14,19
31/10/2020,(ADH) Bishan Home for the Intellectually Disabled,132,125,0,7
31/10/2020,(ADH) Metta Home for the Disabled,103,84,1,19
31/10/2020,(ADH) Singapore Cheshire Home,90,75,2,15
31/10/2020,(ADH) THK Home for the Disabled @ Eunos,88,80,12,8
31/10/2020,(Hostel) MINDSVille @ Napiri,60,48,36,12
31/10/2020,(Hostel) Touch Ubi Hostel,30,28,4,2
31/10/2020,(DAC) BizLink Day Activity Centre,40,39,7,1
31/10/2020,(DAC) Blue Cross Thong Kheng Home,50,32,1,18
31/10/2020,(DAC) Cerebral Palsy Alliance Singapore,70,66,1,4
31/10/2020,(DAC) Eden Centre for Adults @ Clementi,40,44,18,-4
31/10/2020,(DAC) Eden Centre for Adults @ Hougang,40,44,6,-4
31/10/2020,(DAC) MINDS Training & Development Centre @ Ang Mo Kio,55,48,6,7
31/10/2020,(DAC) MINDS Training & Development Centre @ Clementi,55,48,4,7
31/10/2020,(DAC) MINDS Training & Development Centre @ Faber,41,38,6,3
31/10/2020,(DAC) MINDS Training & Development Centre @ Jurong,53,47,7,6
31/10/2020,(DAC) MINDS Training & Development Centre @ Napiri,50,55,11,-5
31/10/2020,(DAC) MINDS Training & Development Centre @ Tampines,47,53,2,-6
31/10/2020,(DAC) Red Cross Day Activity Centre,50,12,7,38
31/10/2020,(DAC) SPD Day Activity Centre,91,82,10,9
31/10/2020,(DAC) St Andrew's Autism Centre (Sengkang),50,34,13,16
31/10/2020,(DAC) St Andrew's Autism Centre (Siglap),73,68,8,5
31/10/2020,(DAC) SUN-DAC @ Bedok,50,43,6,7
31/10/2020,(DAC) SUN-DAC @ Choa Chu Kang,50,51,4,-1
31/10/2020,(DAC) SUN-DAC @ Upper Thomson,120,37,9,83
31/10/2020,(SW) MINDS IDEA Employment Development Centre,300,304,17,-4
31/10/2020,(SW) MINDS Woodlands Employment Development Centre,400,363,37,37
31/10/2020,(SW) SPD Sheltered Workshop,145,126,19,19
30/11/2020,(ADH) Blue Cross Thong Kheng Home,116,93,4,23
30/11/2020,(ADH) Metta Home for the Disabled,103,84,2,19
30/11/2020,(ADH) MINDSVille @ Napiri,160,117,26,43
30/11/2020,(ADH) Singapore Cheshire Home,90,74,4,16
30/11/2020,(ADH) THK Home for the Disabled @ Chai Chee,102,96,9,6
30/11/2020,(ADH) THK Home for the Disabled @ Eunos,88,80,12,8
30/11/2020,(CGH) MINDSVille @ Napiri,10,8,8,2
30/11/2020,(Hostel) MINDSVille @ Napiri,60,49,38,11
30/11/2020,(Hostel) Touch Ubi Hostel,30,29,3,1
30/11/2020,(DAC) BizLink Day Activity Centre,40,39,6,1
30/11/2020,(DAC) SUN-DAC @ Bedok,50,43,5,7
30/11/2020,(DAC) SUN-DAC @ Choa Chu Kang,50,51,3,-1
30/11/2020,(DAC) Bishan Home for the Intellectually Disabled,50,24,0,26
30/11/2020,(DAC) Emmanuel Activity Centre @ Tampines,50,45,7,5
30/11/2020,(DAC) Emmanuel Activity Centre @ Toa Payoh,83,56,19,27
30/11/2020,(DAC) Cerebral Palsy Alliance Singapore,70,65,1,5
30/11/2020,(DAC) Eden Centre for Adults @ Clementi,40,44,19,-4
30/11/2020,(DAC) Eden Centre for Adults @ Hougang,40,44,7,-4
30/11/2020,(DAC) Metta Home @ Hougang,40,30,2,10
30/11/2020,(DAC) Metta Home @ Woodlands,50,28,1,22
30/11/2020,(DAC) MINDS Training & Development Centre @ Clementi,55,49,5,6
30/11/2020,(DAC) MINDS Training & Development Centre @ Eunos,100,71,9,29
30/11/2020,(DAC) MINDS Training & Development Centre @ Faber,41,38,5,3
30/11/2020,(DAC) MINDS Training & Development Centre @ Jurong,53,47,9,6
30/11/2020,(DAC) MINDS Training & Development Centre @ Yishun,61,62,3,-1
30/11/2020,(DAC) Red Cross Day Activity Centre,50,14,4,36
30/11/2020,(DAC) St Andrew's Autism Centre (Sengkang),50,34,12,16
30/11/2020,(DAC) St Andrew's Autism Centre (Siglap),73,70,7,3
30/11/2020,(DAC) THK Day Activity Centre @ Chai Chee,50,19,5,31
30/11/2020,(DAC) THK Autism Centre @ Geylang Bahru,66,26,6,40
30/11/2020,(DAC) TOUCH Centre for Independent Living - Bukit Merah,42,24,4,18
30/11/2020,(DAC) TOUCH Centre for Independent Living - Ubi,50,37,1,13
30/11/2020,(SW) APSN Centre for Adults,170,149,35,21
30/11/2020,(SW) Cerebral Palsy Alliance Singapore GROW,100,87,17,13
30/11/2020,(SW) SIA-MINDS Employment Development Centre,350,379,20,-29
30/11/2020,(SW) MINDS Woodlands Employment Development Centre,400,368,35,32
31/12/2020,(ADH) Blue Cross Thong Kheng Home,116,94,4,22
31/12/2020,(ADH) Metta Home for the Disabled,103,84,2,19
31/12/2020,(ADH) Singapore Cheshire Home,90,74,7,16
31/12/2020,(ADH) THK Home for the Disabled @ Eunos,88,80,12,8
31/12/2020,(Hostel) MINDSVille @ Napiri,60,51,39,9
31/12/2020,(Hostel) THK Home for the Disabled @ Eunos,40,40,30,0
31/12/2020,(Hostel) Touch Ubi Hostel,30,29,3,1
31/12/2020,(DAC) THK Day Activity Centre @ Chai Chee,50,19,5,31
31/12/2020,(DAC) THK Autism Centre @ Geylang Bahru,66,26,7,40
31/12/2020,(DAC) Emmanuel Activity Centre @ Toa Payoh,83,56,18,27
31/12/2020,(DAC) Cerebral Palsy Alliance Singapore,70,65,1,5
31/12/2020,(DAC) Eden Centre for Adults @ Clementi,40,44,18,-4
31/12/2020,(DAC) Metta Home @ Hougang,40,30,2,10
31/12/2020,(DAC) Metta Home @ Woodlands,50,28,1,22
31/12/2020,(DAC) MINDS Training & Development Centre @ Ang Mo Kio,55,48,6,7
31/12/2020,(DAC) MINDS Training & Development Centre @ Clementi,55,50,6,5
31/12/2020,(DAC) MINDS Training & Development Centre @ Eunos,100,70,8,30
31/12/2020,(DAC) MINDS Training & Development Centre @ Faber,41,39,7,2
31/12/2020,(DAC) MINDS Training & Development Centre @ Tampines,47,53,2,-6
31/12/2020,(DAC) MINDS Training & Development Centre @ Yishun,61,61,3,0
31/12/2020,(DAC) SUN-DAC @ Bedok,50,43,5,7
31/12/2020,(DAC) SUN-DAC @ Choa Chu Kang,50,52,3,-2
31/12/2020,(DAC) TOUCH Centre for Independent Living - Bukit Merah,42,24,5,18
31/12/2020,(SW) BizLink Sheltered Workshop,136,149,21,-13
31/12/2020,(SW) Cerebral Palsy Alliance Singapore GROW,100,86,17,14
31/12/2020,(SW) MINDS IDEA Employment Development Centre,300,302,15,-2
31/12/2020,(SW) MINDS Woodlands Employment Development Centre,400,373,33,27
31/12/2020,(SW) SPD Sheltered Workshop,145,129,20,16
29/2/2020,(ADH) THK Home for Disabled @ Sembawang,180,82,27,98
29/2/2020,(ADH) Bishan Home for the Intellectually Disabled,132,124,0,8
29/2/2020,(ADH) Metta Home for the Disabled,103,86,3,17
29/2/2020,(ADH) MINDSVille @ Napiri,160,114,36,46
29/2/2020,(ADH) St Andrew's Adult Home (Sengkang),148,13,22,135
29/2/2020,(ADH) THK Home for the Disabled @ Eunos,88,81,12,7
29/2/2020,(CGH) MINDSVille @ Napiri,10,8,7,2
29/2/2020,(Hostel) MINDSVille @ Napiri,60,45,26,15
29/2/2020,(DAC) THK Autism Centre @ Geylang Bahru,66,23,4,43
29/2/2020,(DAC) BizLink Day Activity Centre,40,32,4,8
29/2/2020,(DAC) Blue Cross Thong Kheng ASD Day Activity Centre,60,40,7,20
29/2/2020,(DAC) Blue Cross Thong Kheng Home,50,35,1,15
29/2/2020,(DAC) Emmanuel Activity Centre @ Toa Payoh,83,56,13,27
29/2/2020,(DAC) Cerebral Palsy Alliance Singapore,70,68,1,2
29/2/2020,(DAC) Eden Centre for Adults @ Clementi,40,44,9,-4
29/2/2020,(DAC) Eden Centre for Adults @ Hougang,40,43,4,-3
29/2/2020,(DAC) Metta Home @ Hougang,40,32,1,8
29/2/2020,(DAC) Metta Home @ Woodlands,50,28,3,22
29/2/2020,(DAC) MINDS Training & Development Centre @ Ang Mo Kio,55,50,2,5
29/2/2020,(DAC) MINDS Training & Development Centre @ Eunos,100,70,2,30
29/2/2020,(DAC) Red Cross Day Activity Centre,50,12,2,38
29/2/2020,(DAC) SPD Day Activity Centre,91,84,3,7
29/2/2020,(DAC) St Andrew's Autism Centre (Siglap),97,69,6,28
29/2/2020,(DAC) SUN-DAC @ Bedok,50,46,1,4
29/2/2020,(DAC) TOUCH Centre for Independent Living - Bukit Merah,42,23,0,19
29/2/2020,(SW) APSN Centre for Adults,170,164,8,6
29/2/2020,(SW) Cerebral Palsy Alliance Singapore GROW,100,88,4,12
29/2/2020,(SW) MINDS IDEA Employment Development Centre,300,303,4,-3
29/2/2020,(SW) SPD Sheltered Workshop,145,131,6,14
31/3/2020,(ADH) Bishan Home for the Intellectually Disabled,132,124,0,8
31/3/2020,(ADH) MINDSVille @ Napiri,160,117,28,43
31/3/2020,(ADH) Red Cross Home for the Disabled,100,95,7,5
31/3/2020,(CGH) MINDSVille @ Napiri,10,8,8,2
31/3/2020,(Hostel) MINDSVille @ Napiri,60,45,29,15
31/3/2020,(Hostel) THK Home for the Disabled @ Eunos,40,43,22,-3
31/3/2020,(DAC) Emmanuel Activity Centre @ Tampines,50,46,4,4
31/3/2020,(DAC) Emmanuel Activity Centre @ Toa Payoh,83,55,14,28
31/3/2020,(DAC) Metta Home @ Hougang,40,32,1,8
31/3/2020,(DAC) THK Day Activity Centre @ Chai Chee,50,18,6,32
31/3/2020,(DAC) THK Autism Centre @ Geylang Bahru,66,24,3,42
31/3/2020,(DAC) Bishan Home for the Intellectually Disabled,50,25,1,25
31/3/2020,(DAC) Eden Centre for Adults @ Hougang,40,43,4,-3
31/3/2020,(DAC) Metta Home @ Woodlands,50,28,3,22
31/3/2020,(DAC) MINDS Training & Development Centre @ Ang Mo Kio,55,50,1,5
31/3/2020,(DAC) MINDS Training & Development Centre @ Eunos,100,71,1,29
31/3/2020,(DAC) MINDS Training & Development Centre @ Jurong,53,45,3,8
31/3/2020,(DAC) MINDS Training & Development Centre @ Napiri,50,60,8,-10
31/3/2020,(DAC) MINDS Training & Development Centre @ Tampines,47,51,3,-4
31/3/2020,(DAC) MINDS Training & Development Centre @ Yishun,61,59,0,2
31/3/2020,(DAC) Red Cross Day Activity Centre,50,12,2,38
31/3/2020,(DAC) SPD Day Activity Centre,91,84,3,7
31/3/2020,(DAC) St Andrew's Autism Centre (Siglap),97,69,4,28
31/3/2020,(DAC) SUN-DAC @ Bedok,50,46,1,4
31/3/2020,(DAC) SUN-DAC @ Choa Chu Kang,50,48,4,2
31/3/2020,(SW) APSN Centre for Adults,170,164,10,6
31/3/2020,(SW) BizLink Sheltered Workshop,136,156,12,-20
31/3/2020,(SW) Cerebral Palsy Alliance Singapore GROW,100,89,3,11
31/3/2020,(SW) MINDS IDEA Employment Development Centre,300,304,2,-4
31/3/2020,(SW) SIA-MINDS Employment Development Centre,350,382,4,-32
31/3/2020,(SW) MINDS Woodlands Employment Development Centre,400,370,10,30
31/3/2020,(SW) SPD Sheltered Workshop,145,135,4,10
30/4/2020,(ADH) THK Home for the Disabled @ Chai Chee,102,99,12,3
30/4/2020,(ADH) Bishan Home for the Intellectually Disabled,132,124,1,8
30/4/2020,(ADH) Blue Cross Thong Kheng Home,116,96,7,20
30/4/2020,(ADH) Metta Home for the Disabled,103,85,4,18
30/4/2020,(ADH) THK Home for Disabled @ Sembawang,180,108,25,72
30/4/2020,(Hostel) THK Home for the Disabled @ Eunos,40,41,24,-1
30/4/2020,(Hostel) Touch Ubi Hostel,30,29,6,1
30/4/2020,(DAC) THK Day Activity Centre @ Chai Chee,50,18,6,32
30/4/2020,(DAC) THK Autism Centre @ Geylang Bahru,66,24,3,42
30/4/2020,(DAC) TOUCH Centre for Independent Living - Bukit Merah,42,23,0,19
30/4/2020,(DAC) TOUCH Centre for Independent Living - Ubi,50,37,0,13
30/4/2020,(DAC) BizLink Day Activity Centre,40,33,2,7
30/4/2020,(DAC) Emmanuel Activity Centre @ Toa Payoh,83,55,14,28
30/4/2020,(DAC) Cerebral Palsy Alliance Singapore,70,67,0,3
30/4/2020,(DAC) Eden Centre for Adults @ Clementi,40,44,9,-4
30/4/2020,(DAC) Eden Centre for Adults @ Hougang,40,44,3,-4
30/4/2020,(DAC) Metta Home @ Hougang,40,32,1,8
30/4/2020,(DAC) Metta Home @ Woodlands,50,29,3,21
30/4/2020,(DAC) MINDS Training & Development Centre @ Clementi,55,49,1,6
30/4/2020,(DAC) MINDS Training & Development Centre @ Faber,41,38,1,3
30/4/2020,(DAC) Singapore Cheshire Home,50,24,0,26
30/4/2020,(DAC) SPD Day Activity Centre,91,84,3,7
30/4/2020,(DAC) SUN-DAC @ Bedok,50,45,1,5
30/4/2020,(SW) Cerebral Palsy Alliance Singapore GROW,100,89,3,11
30/4/2020,(SW) MINDS IDEA Employment Development Centre,300,304,2,-4
30/4/2020,(SW) SIA-MINDS Employment Development Centre,350,382,4,-32
30/4/2020,(SW) MINDS Woodlands Employment Development Centre,400,370,10,30
30/4/2020,(SW) SPD Sheltered Workshop,145,135,4,10
31/5/2020,(ADH) Blue Cross Thong Kheng Home,116,97,7,19
31/5/2020,(ADH) Metta Home for the Disabled,103,85,4,18
31/5/2020,(ADH) MINDSVille @ Napiri,160,117,27,43
31/5/2020,(ADH) Red Cross Home for the Disabled,100,95,6,5
31/5/2020,(ADH) Singapore Cheshire Home,90,75,0,15
31/5/2020,(ADH) St Andrew's Adult Home (Sengkang),148,12,39,136
31/5/2020,(ADH) THK Home for Disabled @ Sembawang,180,113,25,67
31/5/2020,(CGH) MINDSVille @ Napiri,10,8,8,2
31/5/2020,(Hostel) MINDSVille @ Napiri,60,46,34,14
31/5/2020,(Hostel) Touch Ubi Hostel,30,29,6,1
31/5/2020,(DAC) Emmanuel Activity Centre @ Tampines,50,46,4,4
31/5/2020,(DAC) THK Day Activity Centre @ Chai Chee,50,19,6,31
31/5/2020,(DAC) THK Autism Centre @ Geylang Bahru,66,24,3,42
31/5/2020,(DAC) Blue Cross Thong Kheng ASD Day Activity Centre,60,41,7,19
31/5/2020,(DAC) Blue Cross Thong Kheng Home,50,33,1,17
31/5/2020,(DAC) Eden Centre for Adults @ Clementi,40,44,9,-4
31/5/2020,(DAC) Metta Home @ Hougang,40,32,1,8
31/5/2020,(DAC) MINDS Training & Development Centre @ Ang Mo Kio,55,50,1,5
31/5/2020,(DAC) Singapore Cheshire Home,50,24,0,26
31/5/2020,(DAC) St Andrew's Autism Centre (Sengkang),50,32,7,18
31/5/2020,(DAC) St Andrew's Autism Centre (Siglap),97,69,4,28
31/5/2020,(DAC) SUN-DAC @ Bedok,50,45,1,5
31/5/2020,(DAC) SUN-DAC @ Choa Chu Kang,50,49,3,1
31/5/2020,(DAC) SUN-DAC @ Upper Thomson,120,39,0,81
31/5/2020,(DAC) TOUCH Centre for Independent Living - Ubi,50,36,0,14
31/5/2020,(SW) Cerebral Palsy Alliance Singapore GROW,100,89,3,11
30/6/2020,(ADH) THK Home for the Disabled @ Chai Chee,102,103,13,-1
30/6/2020,(ADH) THK Home for Disabled @ Sembawang,180,115,25,65
30/6/2020,(Hostel) Touch Ubi Hostel,30,29,6,1
30/6/2020,(ADH) Bishan Home for the Intellectually Disabled,132,124,2,8
30/6/2020,(ADH) Metta Home for the Disabled,103,85,2,18
30/6/2020,(ADH) Singapore Cheshire Home,90,75,0,15
30/6/2020,(ADH) St Andrew's Adult Home (Sengkang),148,14,36,134
30/6/2020,(CGH) MINDSVille @ Napiri,10,8,8,2
30/6/2020,(DAC) THK Day Activity Centre @ Chai Chee,50,19,6,31
30/6/2020,(DAC) Bishan Home for the Intellectually Disabled,50,24,1,26
30/6/2020,(DAC) BizLink Day Activity Centre,40,37,2,3
30/6/2020,(DAC) Blue Cross Thong Kheng ASD Day Activity Centre,60,41,7,19
30/6/2020,(DAC) Blue Cross Thong Kheng Home,50,33,1,17
30/6/2020,(DAC) Emmanuel Activity Centre @ Tampines,50,46,4,4
30/6/2020,(DAC) Eden Centre for Adults @ Clementi,40,44,9,-4
30/6/2020,(DAC) Metta Home @ Woodlands,50,30,1,20
30/6/2020,(DAC) MINDS Training & Development Centre @ Ang Mo Kio,55,49,1,6
30/6/2020,(DAC) MINDS Training & Development Centre @ Clementi,55,49,1,6
30/6/2020,(DAC) MINDS Training & Development Centre @ Eunos,100,71,2,29
30/6/2020,(DAC) MINDS Training & Development Centre @ Faber,41,38,1,3
30/6/2020,(DAC) MINDS Training & Development Centre @ Jurong,53,45,4,8
30/6/2020,(DAC) MINDS Training & Development Centre @ Napiri,50,58,8,-8
30/6/2020,(DAC) MINDS Training & Development Centre @ Tampines,47,51,3,-4
30/6/2020,(DAC) Red Cross Day Activity Centre,50,12,2,38
30/6/2020,(DAC) Singapore Cheshire Home,50,23,0,27
30/6/2020,(DAC) St Andrew's Autism Centre (Sengkang),50,32,7,18
30/6/2020,(DAC) SUN-DAC @ Bedok,50,45,1,5
30/6/2020,(DAC) SUN-DAC @ Choa Chu Kang,50,49,3,1
30/6/2020,(DAC) TOUCH Centre for Independent Living - Bukit Merah,42,22,0,20
30/6/2020,(SW) MINDS IDEA Employment Development Centre,300,304,3,-4
30/6/2020,(SW) SIA-MINDS Employment Development Centre,350,382,3,-32
30/6/2020,(SW) MINDS Woodlands Employment Development Centre,400,370,11,30
30/6/2020,(SW) SPD Sheltered Workshop,145,132,4,13
31/7/2020,(ADH) Bishan Home for the Intellectually Disabled,132,124,2,8
31/7/2020,(ADH) Blue Cross Thong Kheng Home,116,95,6,21
31/7/2020,(ADH) Metta Home for the Disabled,103,85,3,18
31/7/2020,(ADH) MINDSVille @ Napiri,160,117,27,43
31/7/2020,(ADH) Red Cross Home for the Disabled,100,95,6,5
31/7/2020,(ADH) Singapore Cheshire Home,90,75,1,15
31/7/2020,(ADH) St Andrew's Adult Home (Sengkang),148,15,36,133
31/7/2020,(Hostel) THK Home for the Disabled @ Eunos,40,37,23,3
31/7/2020,(Hostel) Touch Ubi Hostel,30,29,6,1
31/7/2020,(DAC) BizLink Day Activity Centre,40,37,6,3
31/7/2020,(DAC) Emmanuel Activity Centre @ Tampines,50,46,4,4
31/7/2020,(DAC) Cerebral Palsy Alliance Singapore,70,66,2,4
31/7/2020,(DAC) Eden Centre for Adults @ Clementi,40,44,12,-4
31/7/2020,(DAC) Eden Centre for Adults @ Hougang,40,44,4,-4
31/7/2020,(DAC) MINDS Training & Development Centre @ Ang Mo Kio,55,49,2,6
31/7/2020,(DAC) MINDS Training & Development Centre @ Eunos,100,69,5,31
31/7/2020,(DAC) MINDS Training & Development Centre @ Faber,41,37,2,4
31/7/2020,(DAC) MINDS Training & Development Centre @ Jurong,53,45,7,8
31/7/2020,(DAC) MINDS Training & Development Centre @ Yishun,61,59,5,2
31/7/2020,(DAC) Singapore Cheshire Home,50,23,3,27
31/7/2020,(DAC) SPD Day Activity Centre,91,81,7,10
31/7/2020,(DAC) St Andrew's Autism Centre (Siglap),73,69,6,4
31/7/2020,(DAC) SUN-DAC @ Choa Chu Kang,50,50,3,0
31/7/2020,(DAC) THK Autism Centre @ Geylang Bahru,66,28,4,38
31/7/2020,(DAC) TOUCH Centre for Independent Living - Ubi,50,36,0,14
31/7/2020,(SW) MINDS Woodlands Employment Development Centre,400,369,25,31
31/7/2020,(SW) SPD Sheltered Workshop,145,132,10,13
31/8/2020,(ADH) Bishan Home for the Intellectually Disabled,132,124,1,8
31/8/2020,(ADH) Blue Cross Thong Kheng Home,116,93,8,23
31/8/2020,(ADH) Metta Home for the Disabled,103,85,2,18
31/8/2020,(ADH) Singapore Cheshire Home,90,75,1,15
31/8/2020,(ADH) St Andrew's Adult Home (Sengkang),148,20,36,128
31/8/2020,(Hostel) MINDSVille @ Napiri,60,47,36,13
31/8/2020,(DAC) Bishan Home for the Intellectually Disabled,50,24,0,26
31/8/2020,(DAC) Blue Cross Thong Kheng ASD Day Activity Centre,60,36,14,24
31/8/2020,(DAC) Blue Cross Thong Kheng Home,50,32,1,18
31/8/2020,(DAC) Eden Centre for Adults @ Hougang,40,44,7,-4
31/8/2020,(DAC) MINDS Training & Development Centre @ Ang Mo Kio,55,48,3,7
31/8/2020,(DAC) MINDS Training & Development Centre @ Faber,41,37,7,4
31/8/2020,(DAC) MINDS Training & Development Centre @ Jurong,53,46,7,7
31/8/2020,(DAC) MINDS Training & Development Centre @ Napiri,50,56,13,-6
31/8/2020,(DAC) MINDS Training & Development Centre @ Tampines,47,52,4,-5
31/8/2020,(DAC) Singapore Cheshire Home,50,23,4,27
31/8/2020,(DAC) SPD Day Activity Centre,91,81,11,10
31/8/2020,(DAC) St Andrew's Autism Centre (Sengkang),50,33,18,17
31/8/2020,(DAC) St Andrew's Autism Centre (Siglap),73,68,10,5
31/8/2020,(DAC) SUN-DAC @ Bedok,50,44,3,6
31/8/2020,(DAC) SUN-DAC @ Choa Chu Kang,50,50,3,0
31/8/2020,(DAC) THK Day Activity Centre @ Chai Chee,50,18,6,32
31/8/2020,(DAC) THK Autism Centre @ Geylang Bahru,66,26,5,40
31/8/2020,(SW) APSN Centre for Adults,170,151,29,19
31/8/2020,(SW) BizLink Sheltered Workshop,136,148,16,-12
31/8/2020,(SW) SPD Sheltered Workshop,145,129,10,16
31/8/2020,(SW) THK-Pan-Disability Centre,100,81,8,19
30/9/2020,(ADH) Metta Home for the Disabled,103,85,1,18
30/9/2020,(ADH) Red Cross Home for the Disabled,100,94,4,6
30/9/2020,(ADH) Singapore Cheshire Home,90,75,1,15
30/9/2020,(ADH) THK Home for the Disabled @ Chai Chee,102,97,9,5
30/9/2020,(ADH) THK Home for the Disabled @ Eunos,88,81,12,7
30/9/2020,(DAC) Blue Cross Thong Kheng ASD Day Activity Centre,60,35,13,25
30/9/2020,(DAC) Blue Cross Thong Kheng Home,50,32,1,18
30/9/2020,(DAC) Emmanuel Activity Centre @ Tampines,50,45,6,5
30/9/2020,(DAC) Cerebral Palsy Alliance Singapore,70,66,1,4
30/9/2020,(DAC) Eden Centre for Adults @ Clementi,40,44,16,-4
30/9/2020,(DAC) MINDS Training & Development Centre @ Ang Mo Kio,55,48,4,7
30/9/2020,(DAC) MINDS Training & Development Centre @ Eunos,100,69,9,31
30/9/2020,(DAC) MINDS Training & Development Centre @ Faber,41,37,7,4
30/9/2020,(DAC) MINDS Training & Development Centre @ Jurong,53,47,8,6
30/9/2020,(DAC) MINDS Training & Development Centre @ Tampines,47,52,4,-5
30/9/2020,(DAC) MINDS Training & Development Centre @ Yishun,61,59,6,2
30/9/2020,(DAC) Red Cross Day Activity Centre,50,12,7,38
30/9/2020,(DAC) Singapore Cheshire Home,50,23,4,27
30/9/2020,(DAC) SUN-DAC @ Bedok,50,44,5,6
30/9/2020,(DAC) SUN-DAC @ Upper Thomson,120,39,9,81
30/9/2020,(DAC) THK Day Activity Centre @ Chai Chee,50,19,5,31
30/9/2020,(DAC) TOUCH Centre for Independent Living - Ubi,50,36,1,14
30/9/2020,(SW) BizLink Sheltered Workshop,136,148,13,-12
30/9/2020,(SW) MINDS IDEA Employment Development Centre,300,304,18,-4
30/9/2020,(SW) SIA-MINDS Employment Development Centre,350,382,23,-32
30/9/2020,(SW) MINDS Woodlands Employment Development Centre,400,364,36,36
30/9/2020,(SW) SPD Sheltered Workshop,145,128,11,17
31/1/2021,(ADH) Bishan Home for the Intellectually Disabled,132,125,0,7
31/1/2021,(ADH) Blue Cross Thong Kheng Home,116,95,4,21
31/1/2021,(ADH) Metta Home for the Disabled,103,84,3,19
31/1/2021,(ADH) Singapore Cheshire Home,90,73,6,17
31/1/2021,(ADH) St Andrew's Adult Home (Sengkang),148,22,16,126
31/1/2021,(ADH) THK Home for the Disabled @ Eunos,88,80,12,8
31/1/2021,(ADH) THK Home for Disabled @ Sembawang,180,123,34,57
31/1/2021,(CGH) MINDSVille @ Napiri,10,8,8,2
31/1/2021,(Hostel) MINDSVille @ Napiri,60,50,40,10
31/1/2021,(Hostel) THK Home for the Disabled @ Eunos,40,40,31,0
31/1/2021,(DAC) BizLink Day Activity Centre,40,38,9,2
31/1/2021,(DAC) Blue Cross Thong Kheng Home,50,31,1,19
31/1/2021,(DAC) MINDS Training & Development Centre @ Eunos,100,75,3,25
31/1/2021,(DAC) MINDS Training & Development Centre @ Faber,41,44,3,-3
31/1/2021,(DAC) SPD Day Activity Centre,91,87,6,4
31/1/2021,(DAC) St Andrew's Autism Centre (Siglap),73,73,4,0
31/1/2021,(DAC) SUN-DAC @ Bedok,50,43,4,7
31/1/2021,(DAC) TOUCH Centre for Independent Living - Bukit Merah,42,25,2,17
31/1/2021,(SW) APSN Centre for Adults,170,163,17,7
31/1/2021,(SW) BizLink Sheltered Workshop,136,147,21,-11
31/1/2021,(SW) Cerebral Palsy Alliance Singapore GROW,100,90,10,10
31/1/2021,(SW) MINDS IDEA Employment Development Centre,300,306,9,-6
31/1/2021,(SW) SPD Sheltered Workshop,145,126,16,19
31/10/2021,(ADH) Blue Cross Thong Kheng Home,116,88,15,28
31/10/2021,(ADH) Metta Home for the Disabled,103,85,2,18
31/10/2021,(ADH) St Andrew's Adult Home (Sengkang),148,21,18,127
31/10/2021,(ADH) THK Home for the Disabled @ Chai Chee,102,96,15,6
31/10/2021,(ADH) THK Home for the Disabled @ Eunos,88,78,15,10
31/10/2021,(ADH) THK Home for Disabled @ Sembawang,180,124,34,56
31/10/2021,(Hostel) Touch Ubi Hostel,30,29,5,1
31/10/2021,(DAC) Bishan Home for the Intellectually Disabled,50,24,2,26
31/10/2021,(DAC) Emmanuel Activity Centre @ Tampines,50,48,7,2
31/10/2021,(DAC) Cerebral Palsy Alliance Singapore,70,62,4,8
31/10/2021,(DAC) Eden Centre for Adults @ Clementi,40,44,20,-4
31/10/2021,(DAC) Eden Centre for Adults @ Hougang,40,41,6,-1
31/10/2021,(DAC) MINDS Training & Development Centre @ Clementi,55,55,3,0
31/10/2021,(DAC) MINDS Training & Development Centre @ Faber,41,46,14,-5
31/10/2021,(DAC) MINDS Training & Development Centre @ Tampines,47,50,3,-3
31/10/2021,(DAC) St Andrew's Autism Centre (Siglap),73,71,5,2
31/10/2021,(DAC) SUN-DAC @ Bedok,50,43,6,7
31/10/2021,(DAC) SUN-DAC @ Choa Chu Kang,50,50,4,0
31/10/2021,(DAC) SUN-DAC @ Upper Thomson,120,47,11,73
31/10/2021,(DAC) TOUCH Centre for Independent Living - Bukit Merah,42,26,3,16
31/10/2021,(DAC) TOUCH Centre for Independent Living - Ubi,50,40,5,10
31/10/2021,(SW) Cerebral Palsy Alliance Singapore GROW,100,90,8,10
31/10/2021,(SW) MINDS IDEA Employment Development Centre,300,312,12,-12
31/10/2021,(SW) MINDS Woodlands Employment Development Centre,400,394,16,6
31/10/2021,(SW) THK-Pan-Disability Centre,100,85,16,15
30/11/2021,(ADH) Bishan Home for the Intellectually Disabled,132,124,3,8
30/11/2021,(ADH) Red Cross Home for the Disabled,100,96,8,4
30/11/2021,(ADH) St Andrew's Adult Home (Sengkang),148,21,17,127
30/11/2021,(ADH) THK Home for Disabled @ Sembawang,180,123,35,57
30/11/2021,(Hostel) MINDSVille @ Napiri,60,48,49,12
30/11/2021,(Hostel) THK Home for the Disabled @ Eunos,40,39,36,1
30/11/2021,(DAC) Emmanuel Activity Centre @ Toa Payoh,83,60,20,23
30/11/2021,(DAC) Bishan Home for the Intellectually Disabled,50,24,1,26
30/11/2021,(DAC) Blue Cross Thong Kheng Home,50,31,1,19
30/11/2021,(DAC) Eden Centre for Adults @ Hougang,40,41,8,-1
30/11/2021,(DAC) MINDS Training & Development Centre @ Eunos,100,75,5,25
30/11/2021,(DAC) MINDS Training & Development Centre @ Faber,41,46,19,-5
30/11/2021,(DAC) MINDS Training & Development Centre @ Napiri,50,57,11,-7
30/11/2021,(DAC) Singapore Cheshire Home,50,23,1,27
30/11/2021,(DAC) SUN-DAC @ Choa Chu Kang,50,50,7,0
30/11/2021,(DAC) SUN-DAC @ Upper Thomson,120,47,17,73
30/11/2021,(DAC) THK Day Activity Centre @ Chai Chee,50,21,4,29
30/11/2021,(DAC) THK Autism Centre @ Geylang Bahru,66,30,9,36
30/11/2021,(DAC) TOUCH Centre for Independent Living - Bukit Merah,42,27,2,15
30/11/2021,(SW) APSN Centre for Adults,170,166,20,4
30/11/2021,(SW) BizLink Sheltered Workshop,136,146,23,-10
30/11/2021,(SW) Cerebral Palsy Alliance Singapore GROW,100,88,9,12
30/11/2021,(SW) SIA-MINDS Employment Development Centre,350,388,15,-38
31/12/2021,(ADH) Bishan Home for the Intellectually Disabled,132,124,3,8
31/12/2021,(ADH) Red Cross Home for the Disabled,100,96,11,4
31/12/2021,(ADH) Singapore Cheshire Home,90,74,6,16
31/12/2021,(ADH) THK Home for the Disabled @ Chai Chee,102,96,14,6
31/12/2021,(ADH) THK Home for the Disabled @ Eunos,88,76,19,12
31/12/2021,(ADH) THK Home for Disabled @ Sembawang,180,122,35,58
31/12/2021,(Hostel) THK Home for the Disabled @ Eunos,50,40,36,10
31/12/2021,(Hostel) Touch Ubi Hostel,30,29,5,1
31/12/2021,(ADH) Metta Home for the Disabled,103,86,1,17
31/12/2021,(DAC) BizLink Day Activity Centre,50,31,7,19
31/12/2021,(DAC) Emmanuel Activity Centre @ Tampines,50,36,7,14
31/12/2021,(DAC) Eden Centre for Adults @ Clementi,50,33,19,17
31/12/2021,(DAC) MINDS Training & Development Centre @ Faber,41,45,21,-4
31/12/2021,(DAC) MINDS Training & Development Centre @ Napiri,50,57,10,-7
31/12/2021,(DAC) Singapore Cheshire Home,50,23,2,27
31/12/2021,(DAC) SUN-DAC @ Upper Thomson,50,35,15,15
31/12/2021,(DAC) TOUCH Centre for Independent Living - Bukit Merah,42,27,2,15
31/12/2021,(DAC) Bishan Home for the Intellectually Disabled,50,24,0,26
31/12/2021,(DAC) Red Cross Day Activity Centre,50,16,7,34
31/12/2021,(DAC) St Andrew's Autism Centre (Sengkang),50,40,12,10
31/12/2021,(DAC) TOUCH Centre for Independent Living - Ubi,50,39,5,11
31/12/2021,(SW) Cerebral Palsy Alliance Singapore GROW,100,89,11,11
31/12/2021,(SW) MINDS IDEA Employment Development Centre,300,309,16,-9
31/12/2021,(SW) THK-Pan-Disability Centre,100,88,20,12
28/2/2021,(ADH) Bishan Home for the Intellectually Disabled,132,125,0,7
28/2/2021,(ADH) Blue Cross Thong Kheng Home,116,92,4,24
28/2/2021,(ADH) Metta Home for the Disabled,103,86,2,17
28/2/2021,(ADH) THK Home for the Disabled @ Chai Chee,102,95,14,7
28/2/2021,(ADH) THK Home for the Disabled @ Eunos,88,80,12,8
28/2/2021,(Hostel) MINDSVille @ Napiri,60,50,39,10
28/2/2021,(Hostel) Touch Ubi Hostel,30,29,2,1
28/2/2021,(DAC) Emmanuel Activity Centre @ Tampines,50,45,5,5
28/2/2021,(DAC) Emmanuel Activity Centre @ Toa Payoh,83,56,18,27
28/2/2021,(DAC) Cerebral Palsy Alliance Singapore,70,64,1,6
28/2/2021,(DAC) Metta Home @ Hougang,40,32,1,8
28/2/2021,(DAC) Metta Home @ Woodlands,50,28,2,22
28/2/2021,(DAC) MINDS Training & Development Centre @ Ang Mo Kio,55,51,4,4
28/2/2021,(DAC) MINDS Training & Development Centre @ Eunos,100,76,1,24
28/2/2021,(DAC) MINDS Training & Development Centre @ Faber,41,44,4,-3
28/2/2021,(DAC) MINDS Training & Development Centre @ Napiri,50,57,10,-7
28/2/2021,(DAC) MINDS Training & Development Centre @ Yishun,61,62,0,-1
28/2/2021,(DAC) Red Cross Day Activity Centre,50,15,3,35
28/2/2021,(DAC) Singapore Cheshire Home,50,24,3,26
28/2/2021,(DAC) SPD Day Activity Centre,91,87,6,4
28/2/2021,(DAC) St Andrew's Autism Centre (Sengkang),50,42,5,8
28/2/2021,(DAC) St Andrew's Autism Centre (Siglap),73,73,4,0
28/2/2021,(DAC) SUN-DAC @ Bedok,50,44,4,6
28/2/2021,(DAC) THK Autism Centre @ Geylang Bahru,66,28,8,38
28/2/2021,(DAC) TOUCH Centre for Independent Living - Bukit Merah,42,25,1,17
28/2/2021,(DAC) TOUCH Centre for Independent Living - Ubi,50,38,2,12
28/2/2021,(SW) Cerebral Palsy Alliance Singapore GROW,100,93,3,7
31/3/2021,(ADH) MINDSVille @ Napiri,160,120,28,40
31/3/2021,(ADH) Singapore Cheshire Home,90,74,6,16
31/3/2021,(ADH) THK Home for the Disabled @ Eunos,88,81,13,7
31/3/2021,(Hostel) THK Home for the Disabled @ Eunos,40,40,33,0
31/3/2021,(ADH) Bishan Home for the Intellectually Disabled,132,123,0,9
31/3/2021,(ADH) Red Cross Home for the Disabled,100,95,5,5
31/3/2021,(ADH) THK Home for the Disabled @ Chai Chee,102,95,13,7
31/3/2021,(ADH) THK Home for Disabled @ Sembawang,180,125,39,55
31/3/2021,(Hostel) MINDSVille @ Napiri,60,50,40,10
31/3/2021,(DAC) Emmanuel Activity Centre @ Tampines,50,45,6,5
31/3/2021,(DAC) Emmanuel Activity Centre @ Toa Payoh,83,56,18,27
31/3/2021,(DAC) Cerebral Palsy Alliance Singapore,70,64,1,6
31/3/2021,(DAC) Metta Home @ Woodlands,50,29,1,21
31/3/2021,(DAC) MINDS Training & Development Centre @ Clementi,55,51,7,4
31/3/2021,(DAC) MINDS Training & Development Centre @ Eunos,100,77,1,23
31/3/2021,(DAC) MINDS Training & Development Centre @ Napiri,50,57,9,-7
31/3/2021,(DAC) MINDS Training & Development Centre @ Yishun,61,62,2,-1
31/3/2021,(DAC) Singapore Cheshire Home,50,26,0,24
31/3/2021,(DAC) SUN-DAC @ Bedok,50,44,3,6
31/3/2021,(SW) MINDS IDEA Employment Development Centre,300,312,5,-12
31/3/2021,(SW) SIA-MINDS Employment Development Centre,350,387,9,-37
31/3/2021,(SW) SPD Sheltered Workshop,145,126,16,19
31/3/2021,(SW) THK-Pan-Disability Centre,100,84,7,16
31/3/2021,(DAC) Blue Cross Thong Kheng ASD Day Activity Centre,60,37,5,23
31/3/2021,(DAC) Blue Cross Thong Kheng Home,50,31,1,19
31/3/2021,(DAC) Eden Centre for Adults @ Clementi,40,44,19,-4
31/3/2021,(DAC) MINDS Training & Development Centre @ Tampines,47,53,1,-6
31/3/2021,(DAC) SPD Day Activity Centre,91,87,6,4
31/3/2021,(DAC) St Andrew's Autism Centre (Sengkang),50,42,5,8
31/3/2021,(DAC) St Andrew's Autism Centre (Siglap),73,73,4,0
30/3/2021,(DAC) SUN-DAC @ Choa Chu Kang,50,51,3,-1
31/3/2021,(DAC) SUN-DAC @ Upper Thomson,120,42,3,78
31/3/2021,(DAC) TOUCH Centre for Independent Living - Bukit Merah,42,25,1,17
31/3/2021,(DAC) TOUCH Centre for Independent Living - Ubi,50,38,4,12
31/3/2021,(SW) MINDS Woodlands Employment Development Centre,400,392,16,8
30/4/2021,(ADH) Bishan Home for the Intellectually Disabled,132,123,0,9
30/4/2021,(ADH) Metta Home for the Disabled,103,86,5,17
30/4/2021,(ADH) MINDSVille @ Napiri,160,117,30,43
30/4/2021,(Hostel) Touch Ubi Hostel,30,29,3,1
30/4/2021,(DAC) Emmanuel Activity Centre @ Toa Payoh,83,56,16,27
30/4/2021,(DAC) Eden Centre for Adults @ Clementi,40,44,19,-4
30/4/2021,(DAC) Eden Centre for Adults @ Hougang,40,44,8,-4
30/4/2021,(DAC) Metta Home @ Hougang,40,32,3,8
30/4/2021,(DAC) MINDS Training & Development Centre @ Jurong,53,51,15,2
30/4/2021,(DAC) MINDS Training & Development Centre @ Tampines,47,53,3,-6
30/4/2021,(DAC) MINDS Training & Development Centre @ Yishun,61,62,2,-1
30/4/2021,(DAC) Red Cross Day Activity Centre,50,15,4,35
30/4/2021,(DAC) SUN-DAC @ Choa Chu Kang,50,49,3,1
30/4/2021,(DAC) THK Autism Centre @ Geylang Bahru,66,26,8,40
30/4/2021,(DAC) TOUCH Centre for Independent Living - Bukit Merah,42,25,0,17
30/4/2021,(DAC) TOUCH Centre for Independent Living - Ubi,50,39,4,11
30/4/2021,(SW) Cerebral Palsy Alliance Singapore GROW,100,92,2,8
30/4/2021,(SW) MINDS IDEA Employment Development Centre,300,311,9,-11
30/4/2021,(SW) SIA-MINDS Employment Development Centre,350,388,7,-38
30/4/2021,(SW) MINDS Woodlands Employment Development Centre,400,397,13,3
30/4/2021,(SW) THK-Pan-Disability Centre,100,86,5,14
31/5/2021,(ADH) Bishan Home for the Intellectually Disabled,132,123,3,9
31/5/2021,(ADH) Metta Home for the Disabled,103,86,5,17
31/5/2021,(ADH) MINDSVille @ Napiri,160,116,31,44
31/5/2021,(ADH) Red Cross Home for the Disabled,100,95,7,5
31/5/2021,(ADH) St Andrew's Adult Home (Sengkang),148,21,15,127
31/5/2021,(ADH) THK Home for the Disabled @ Chai Chee,102,95,14,7
31/5/2021,(ADH) THK Home for the Disabled @ Eunos,88,81,14,7
31/5/2021,(ADH) THK Home for Disabled @ Sembawang,180,123,28,57
31/5/2021,(CGH) MINDSVille @ Napiri,10,8,8,2
31/5/2021,(Hostel) MINDSVille @ Napiri,60,48,44,12
31/5/2021,(Hostel) THK Home for the Disabled @ Eunos,40,39,34,1
31/5/2021,(Hostel) Touch Ubi Hostel,30,29,3,1
31/5/2021,(DAC) Blue Cross Thong Kheng ASD Day Activity Centre,60,37,5,23
31/5/2021,(DAC) Emmanuel Activity Centre @ Tampines,50,45,5,5
31/5/2021,(DAC) Emmanuel Activity Centre @ Toa Payoh,83,56,14,27
31/5/2021,(DAC) Eden Centre for Adults @ Clementi,40,44,19,-4
31/5/2021,(DAC) Metta Home @ Woodlands,50,29,3,21
31/5/2021,(DAC) MINDS Training & Development Centre @ Ang Mo Kio,55,50,5,5
31/5/2021,(DAC) MINDS Training & Development Centre @ Clementi,55,52,5,3
31/5/2021,(DAC) MINDS Training & Development Centre @ Jurong,53,51,15,2
31/5/2021,(DAC) MINDS Training & Development Centre @ Napiri,50,58,9,-8
31/5/2021,(DAC) MINDS Training & Development Centre @ Tampines,47,52,3,-5
31/5/2021,(DAC) MINDS Training & Development Centre @ Yishun,61,62,2,-1
31/5/2021,(DAC) Red Cross Day Activity Centre,50,15,4,35
31/5/2021,(DAC) Singapore Cheshire Home,50,26,0,24
31/5/2021,(DAC) SPD Day Activity Centre,91,86,6,5
31/5/2021,(DAC) SUN-DAC @ Choa Chu Kang,50,49,2,1
31/5/2021,(DAC) SUN-DAC @ Upper Thomson,120,43,5,77
31/5/2021,(DAC) THK Autism Centre @ Geylang Bahru,66,28,6,38
31/5/2021,(SW) BizLink Sheltered Workshop,136,143,21,-7
31/5/2021,(SW) Cerebral Palsy Alliance Singapore GROW,100,92,1,8
31/5/2021,(SW) MINDS IDEA Employment Development Centre,300,309,9,-9
31/5/2021,(SW) SIA-MINDS Employment Development Centre,350,388,8,-38
31/5/2021,(SW) MINDS Woodlands Employment Development Centre,400,397,12,3
31/5/2021,(SW) SPD Sheltered Workshop,145,130,13,15
31/5/2021,(SW) THK-Pan-Disability Centre,100,84,4,16
30/6/2021,(ADH) St Andrew's Adult Home (Sengkang),148,21,15,127
30/6/2021,(ADH) THK Home for the Disabled @ Chai Chee,102,95,13,7
30/6/2021,(ADH) THK Home for the Disabled @ Eunos,88,80,14,8
30/6/2021,(CGH) MINDSVille @ Napiri,10,8,8,2
30/6/2021,(Hostel) MINDSVille @ Napiri,60,49,43,11
30/6/2021,(Hostel) Touch Ubi Hostel,30,29,5,1
30/6/2021,(DAC) Metta Home @ Hougang,40,32,3,8
30/6/2021,(DAC) Metta Home @ Woodlands,50,29,3,21
30/6/2021,(DAC) BizLink Day Activity Centre,40,41,1,-1
30/6/2021,(DAC) Emmanuel Activity Centre @ Toa Payoh,83,58,14,25
30/6/2021,(DAC) MINDS Training & Development Centre @ Clementi,55,53,5,2
30/6/2021,(DAC) MINDS Training & Development Centre @ Faber,41,46,5,-5
30/6/2021,(DAC) MINDS Training & Development Centre @ Jurong,53,51,17,2
30/6/2021,(DAC) MINDS Training & Development Centre @ Yishun,61,63,1,-2
30/6/2021,(DAC) Red Cross Day Activity Centre,50,15,4,35
30/6/2021,(DAC) SPD Day Activity Centre,91,86,6,5
30/6/2021,(DAC) St Andrew's Autism Centre (Sengkang),50,42,6,8
30/6/2021,(DAC) SUN-DAC @ Bedok,50,44,2,6
30/6/2021,(DAC) SUN-DAC @ Upper Thomson,120,43,8,77
30/6/2021,(SW) MINDS IDEA Employment Development Centre,300,309,10,-9
30/6/2021,(SW) SIA-MINDS Employment Development Centre,350,387,10,-37
30/6/2021,(SW) MINDS Woodlands Employment Development Centre,400,393,15,7
30/6/2021,(SW) THK-Pan-Disability Centre,100,84,4,16
31/7/2021,(ADH) THK Home for Disabled @ Sembawang,180,124,28,56
31/7/2021,(ADH) Blue Cross Thong Kheng Home,116,90,12,26
31/7/2021,(ADH) Metta Home for the Disabled,103,84,3,19
31/7/2021,(ADH) MINDSVille @ Napiri,160,116,33,44
31/7/2021,(ADH) Red Cross Home for the Disabled,100,96,8,4
31/7/2021,(ADH) St Andrew's Adult Home (Sengkang),148,20,16,128
31/7/2021,(ADH) THK Home for the Disabled @ Eunos,88,80,15,8
31/7/2021,(CGH) MINDSVille @ Napiri,10,8,8,2
31/7/2021,(DAC) BizLink Day Activity Centre,40,41,1,-1
31/7/2021,(DAC) SUN-DAC @ Bedok,50,44,2,6
31/7/2021,(DAC) Blue Cross Thong Kheng ASD Day Activity Centre,60,34,6,26
31/7/2021,(DAC) Blue Cross Thong Kheng Home,50,31,1,19
31/7/2021,(DAC) MINDS Training & Development Centre @ Ang Mo Kio,55,52,3,3
31/7/2021,(DAC) MINDS Training & Development Centre @ Clementi,55,55,3,0
31/7/2021,(DAC) MINDS Training & Development Centre @ Napiri,50,57,9,-7
31/7/2021,(DAC) MINDS Training & Development Centre @ Yishun,61,62,1,-1
31/7/2021,(DAC) Red Cross Day Activity Centre,50,15,4,35
31/7/2021,(DAC) Singapore Cheshire Home,50,26,0,24
31/7/2021,(DAC) St Andrew's Autism Centre (Sengkang),50,42,6,8
31/7/2021,(SW) BizLink Sheltered Workshop,136,143,21,-7
31/7/2021,(SW) MINDS IDEA Employment Development Centre,300,312,6,-12
31/7/2021,(SW) SIA-MINDS Employment Development Centre,350,386,10,-36
31/7/2021,(SW) SPD Sheltered Workshop,145,123,15,22
31/7/2021,(SW) THK-Pan-Disability Centre,100,85,5,15
31/8/2021,(ADH) Bishan Home for the Intellectually Disabled,132,124,3,8
31/8/2021,(ADH) Blue Cross Thong Kheng Home,116,90,13,26
31/8/2021,(ADH) Metta Home for the Disabled,103,84,3,19
31/8/2021,(ADH) MINDSVille @ Napiri,160,116,35,44
31/8/2021,(ADH) Singapore Cheshire Home,90,73,5,17
31/8/2021,(ADH) St Andrew's Adult Home (Sengkang),148,20,16,128
31/8/2021,(ADH) THK Home for the Disabled @ Chai Chee,102,97,13,5
31/8/2021,(ADH) THK Home for the Disabled @ Eunos,88,79,15,9
31/8/2021,(ADH) THK Home for Disabled @ Sembawang,180,126,31,54
31/8/2021,(CGH) MINDSVille @ Napiri,10,8,8,2
31/8/2021,(Hostel) MINDSVille @ Napiri,60,48,43,12
31/8/2021,(Hostel) Touch Ubi Hostel,30,29,6,1
31/8/2021,(DAC) BizLink Day Activity Centre,40,41,2,-1
31/8/2021,(DAC) Bishan Home for the Intellectually Disabled,50,24,1,26
31/8/2021,(DAC) Blue Cross Thong Kheng ASD Day Activity Centre,60,34,6,26
31/8/2021,(DAC) Emmanuel Activity Centre @ Tampines,50,48,5,2
31/8/2021,(DAC) Cerebral Palsy Alliance Singapore,70,63,3,7
31/8/2021,(DAC) Eden Centre for Adults @ Hougang,40,43,7,-3
31/8/2021,(DAC) Metta Home @ Hougang,40,32,3,8
31/8/2021,(DAC) MINDS Training & Development Centre @ Ang Mo Kio,55,53,2,2
31/8/2021,(DAC) MINDS Training & Development Centre @ Clementi,55,55,3,0
31/8/2021,(DAC) MINDS Training & Development Centre @ Faber,41,46,5,-5
31/8/2021,(DAC) MINDS Training & Development Centre @ Jurong,53,53,14,0
31/8/2021,(DAC) MINDS Training & Development Centre @ Tampines,47,52,2,-5
31/8/2021,(DAC) Red Cross Day Activity Centre,50,15,3,35
31/8/2021,(DAC) Singapore Cheshire Home,50,24,0,26
31/8/2021,(DAC) SUN-DAC @ Bedok,50,44,4,6
31/8/2021,(DAC) THK Day Activity Centre @ Chai Chee,50,22,3,28
31/8/2021,(SW) APSN Centre for Adults,170,170,14,0
31/8/2021,(SW) MINDS Woodlands Employment Development Centre,400,393,19,7
31/8/2021,(SW) SPD Sheltered Workshop,145,128,9,17
30/9/2021,(ADH) Metta Home for the Disabled,103,84,3,19
30/9/2021,(ADH) St Andrew's Adult Home (Sengkang),148,21,17,127
30/9/2021,(ADH) THK Home for the Disabled @ Chai Chee,102,96,14,6
30/9/2021,(ADH) THK Home for the Disabled @ Eunos,88,78,15,10
30/9/2021,(ADH) THK Home for Disabled @ Sembawang,180,125,35,55
30/9/2021,(CGH) MINDSVille @ Napiri,10,8,8,2
30/9/2021,(Hostel) Touch Ubi Hostel,30,29,6,1
30/9/2021,(DAC) Bishan Home for the Intellectually Disabled,50,24,1,26
30/9/2021,(DAC) BizLink Day Activity Centre,40,40,4,0
30/9/2021,(DAC) Blue Cross Thong Kheng ASD Day Activity Centre,60,34,9,26
30/9/2021,(DAC) Emmanuel Activity Centre @ Tampines,50,48,6,2
30/9/2021,(DAC) Emmanuel Activity Centre @ Toa Payoh,83,60,17,23
30/9/2021,(DAC) Cerebral Palsy Alliance Singapore,70,63,3,7
30/9/2021,(DAC) Eden Centre for Adults @ Hougang,40,42,7,-2
30/9/2021,(DAC) Metta Home @ Hougang,40,32,2,8
30/9/2021,(DAC) Metta Home @ Woodlands,50,29,3,21
30/9/2021,(DAC) MINDS Training & Development Centre @ Eunos,100,76,2,24
30/9/2021,(DAC) MINDS Training & Development Centre @ Napiri,50,57,9,-7
30/9/2021,(DAC) Red Cross Day Activity Centre,50,15,3,35
30/9/2021,(DAC) St Andrew's Autism Centre (Siglap),73,71,3,2
30/9/2021,(DAC) SUN-DAC @ Bedok,50,43,4,7
30/9/2021,(DAC) TOUCH Centre for Independent Living - Ubi,50,40,4,10
30/9/2021,(SW) Cerebral Palsy Alliance Singapore GROW,100,92,1,8
30/9/2021,(SW) SIA-MINDS Employment Development Centre,350,389,7,-39
30/9/2021,(SW) SPD Sheltered Workshop,145,127,7,18
30/9/2021,(SW) THK-Pan-Disability Centre,100,85,12,15
31/1/2022,(ADH) Bishan Home for the Intellectually Disabled,132,125,2,7
31/1/2022,(ADH) Blue Cross Thong Kheng Home,116,88,14,28
31/1/2022,(ADH) Metta Home for the Disabled,103,86,2,17
31/1/2022,(ADH) St Andrew's Adult Home (Sengkang),148,20,19,128
31/1/2022,(ADH) THK Home for the Disabled @ Eunos,88,76,20,12
31/1/2022,(ADH) THK Home for Disabled @ Sembawang,180,128,36,52
31/1/2022,(Hostel) MINDSVille @ Napiri,60,48,50,12
31/1/2022,(Hostel) THK Home for the Disabled @ Eunos,50,41,35,9
31/1/2022,(DAC) BizLink Day Activity Centre,40,39,6,1
31/1/2022,(DAC) Bishan Home for the Intellectually Disabled,50,24,0,26
31/1/2022,(DAC) Blue Cross Thong Kheng ASD Day Activity Centre,60,35,11,25
31/1/2022,(DAC) Blue Cross Thong Kheng Home,50,30,1,20
31/1/2022,(DAC) Emmanuel Activity Centre @ Toa Payoh,83,59,22,24
31/1/2022,(DAC) Metta Home @ Woodlands,50,29,5,21
31/1/2022,(DAC) MINDS Training & Development Centre @ Ang Mo Kio,55,51,2,4
31/1/2022,(DAC) MINDS Training & Development Centre @ Faber,41,44,20,-3
31/1/2022,(DAC) MINDS Training & Development Centre @ Jurong,53,52,21,1
31/1/2022,(DAC) Red Cross Day Activity Centre,50,16,9,34
31/1/2022,(DAC) SPD Day Activity Centre,91,84,9,7
31/1/2022,(DAC) St Andrew's Autism Centre (Sengkang),50,40,14,10
31/1/2022,(DAC) SUN-DAC @ Bedok,50,47,2,3
31/1/2022,(DAC) SUN-DAC @ Choa Chu Kang,50,48,6,2
31/1/2022,(DAC) TOUCH Centre for Independent Living - Ubi,50,39,5,11
31/1/2022,(SW) BizLink Sheltered Workshop,136,149,17,-13
31/1/2022,(SW) MINDS IDEA Employment Development Centre,300,310,13,-10
31/1/2022,(SW) SIA-MINDS Employment Development Centre,350,373,10,-23
31/1/2022,(SW) MINDS Woodlands Employment Development Centre,400,390,22,10
28/2/2022,(ADH) Bishan Home for the Intellectually Disabled,132,125,2,7
28/2/2022,(ADH) Blue Cross Thong Kheng Home,116,88,13,28
28/2/2022,(ADH) Metta Home for the Disabled,103,86,1,17
28/2/2022,(ADH) MINDSVille @ Napiri,160,116,36,44
28/2/2022,(ADH) Red Cross Home for the Disabled,100,85,11,15
28/2/2022,(ADH) Singapore Cheshire Home,90,74,7,16
28/2/2022,(ADH) St Andrew's Adult Home (Sengkang),148,20,23,128
28/2/2022,(ADH) THK Home for the Disabled @ Chai Chee,102,97,16,5
28/2/2022,(ADH) THK Home for the Disabled @ Eunos,88,76,20,12
28/2/2022,(ADH) THK Home for Disabled @ Sembawang,180,126,35,54
28/2/2022,(CDH) Chen Su Lan Methodist Children's Home,30,17,0,13
28/2/2022,(CDH) MINDSville @ Napiri Children Wing,36,0,26,36
28/2/2022,(CDH) Red Cross Home for the Disabled,30,0,0,28
28/2/2022,(CDH) THK Home for the Disabled @ Eunos,20,18,5,2
28/2/2022,(DAC) Bishan Home for the Intellectually Disabled,50,24,0,26
28/2/2022,(DAC) BizLink Day Activity Centre,40,41,6,-1
28/2/2022,(DAC) Emmanuel Activity Centre @ Tampines,50,48,5,2
28/2/2022,(DAC) Emmanuel Activity Centre @ Toa Payoh,83,59,22,24
28/2/2022,(DAC) Cerebral Palsy Alliance Singapore,70,66,5,4
28/2/2022,(DAC) Eden Centre for Adults @ Clementi,40,44,20,-4
28/2/2022,(DAC) Eden Centre for Adults @ Hougang,40,43,7,-3
28/2/2022,(DAC) Metta Home @ Woodlands,50,29,5,21
28/2/2022,(DAC) MINDS Training & Development Centre @ Ang Mo Kio,55,51,2,4
28/2/2022,(DAC) MINDS Training & Development Centre @ Clementi,55,55,10,0
28/2/2022,(DAC) MINDS Training & Development Centre @ Eunos,100,78,2,22
28/2/2022,(DAC) MINDS Training & Development Centre @ Faber,41,44,20,-3
28/2/2022,(DAC) MINDS Training & Development Centre @ Jurong,53,52,21,1
28/2/2022,(DAC) MINDS Training & Development Centre @ Napiri,50,56,14,-6
28/2/2022,(DAC) MINDS Training & Development Centre @ Tampines,47,51,2,-4
28/2/2022,(DAC) MINDS Training & Development Centre @ Yishun,61,60,8,1
28/2/2022,(DAC) Red Cross Day Activity Centre,50,16,8,34
28/2/2022,(DAC) Singapore Cheshire Home,50,24,0,26
28/2/2022,(DAC) SPD Day Activity Centre,91,85,7,6
28/2/2022,(DAC) SUN-DAC @ Bedok,50,47,2,3
28/2/2022,(DAC) SUN-DAC @ Choa Chu Kang,50,47,6,3
28/2/2022,(DAC) SUN-DAC @ Upper Thomson,120,49,19,71
28/2/2022,(DAC) THK Day Activity Centre @ Chai Chee,50,21,5,29
28/2/2022,(DAC) THK Autism Centre @ Geylang Bahru,66,30,8,36
28/2/2022,(Hostel) MINDSVille @ Napiri,60,48,49,12
28/2/2022,(Hostel) THK Home for the Disabled @ Eunos,40,41,35,-1
28/2/2022,(Hostel) Touch Ubi Hostel,30,29,6,1
28/2/2022,(SW) APSN Centre for Adults,170,162,7,8
28/2/2022,(SW) BizLink Sheltered Workshop,136,149,18,-13
28/2/2022,(SW) Cerebral Palsy Alliance Singapore GROW,100,91,8,9
28/2/2022,(SW) MINDS IDEA Employment Development Centre,300,313,8,-13
28/2/2022,(SW) SIA-MINDS Employment Development Centre,350,367,11,-17
28/2/2022,(SW) MINDS Woodlands Employment Development Centre,400,394,12,6
28/2/2022,(SW) THK-Pan-Disability Centre,100,84,18,16
28/2/2022,(DAC) Blue Cross Thong Kheng ASD Day Activity Centre,60,35,11,25
28/2/2022,(DAC) Blue Cross Thong Kheng Home,50,29,1,21
28/2/2022,(DAC) Metta Home @ Hougang,40,32,1,8
28/2/2022,(DAC) St Andrew's Autism Centre (Sengkang),50,40,15,10
28/2/2022,(DAC) St Andrew's Autism Centre (Siglap),73,75,5,-2
28/2/2022,(DAC) TOUCH Centre for Independent Living - Bukit Merah,42,27,2,15
28/2/2022,(DAC) TOUCH Centre for Independent Living - Ubi,50,39,5,11
28/2/2022,(SW) SPD Sheltered Workshop,145,128,6,17
